TRB	label
CASSAFPCREGRNNEQFF	NLVPMVATV
CASSLTTESGEQYF	NLVPMVATV
CASSLGTLEETQYF	NLVPMVATV
CASSLDSLNTIYF	NLVPMVATV
CASSQDTASSYEQYF	other
CSADGLPISSYNEQFF	NLVPMVATV
CASSFRQGAFGDTQYF	NLVPMVATV
CASSFGPRAGTTGELFF	NLVPMVATV
CASSYGTGKDFEQFF	NLVPMVATV
CASSEGRISPGELFF	other
CASSFGIYEQYF	other
CSVEAYATDYYGYTF	NLVPMVATV
CASSSGLISFYEQYF	NLVPMVATV
CASSQDRETQYF	other
CASSQFLGAYEQYF	NLVPMVATV
CASSSYRGGETQYF	other
CASSPGDEQFF	NLVPMVATV
CASSGTELQETQYF	NLVPMVATV
CSVEELAGDTDTQYF	NLVPMVATV
CSVEIAGVYNEQFF	other
CASSYAGTVEKLFF	other
CASSSVGVDTQYF	other
CASGGVYSGGAVEQYF	NLVPMVATV
CASSQVGQNLYEQYF	other
CASSAYPSGPEQFF	NLVPMVATV
CASSDGPTGFATQYF	other
CASVPRPGDSTDTQYF	NLVPMVATV
CASSQEDRSYEQYF	NLVPMVATV
CASSEPLAAADEQFF	NLVPMVATV
CASSLGGDTQYF	other
CASSAGTGGGETQYF	other
CASTFRGPTEAFF	other
CASRNPLPTGHRGEAFF	other
CASSYSIGTGRMETQYF	other
CASSMYSVNEQFF	other
CASSEGGPYEQYF	NLVPMVATV
CASSATGLPYEQYF	NLVPMVATV
CSARYRAGASGELFF	NLVPMVATV
CSAADRAYNEQFF	NLVPMVATV
CASSLEGSGGYTF	NLVPMVATV
CASSASGDTGELFF	other
CATSDWLGGTDTQYF	other
CSVDKGGPEAFF	NLVPMVATV
CSARQGQGFLYEQYF	other
CASSFWNGEQFF	other
CAISEDSLHNSPLHF	other
CASSFYITGAPYNEQFF	NLVPMVATV
CASSLWRHLNQPQHF	NLVPMVATV
CAISDGQGPYEQYF	other
CASSLWPKLRYEQYF	other
CASSGGDTQYF	other
CSASPPGTSVNNEQFF	other
CASSLGDRRALFF	NLVPMVATV
CASRTEKTVLLAFF	other
CASSLGGSAYNEQFF	other
CASSAVGVPHVEKLFF	other
CATPKGEASTEAFF	other
CASNVYSGANVLTF	other
CASSFSAGELFF	other
CASSPWGGNTEAFF	other
CASRTGAQPQHF	NLVPMVATV
CASRPSDLQPQHF	NLVPMVATV
CASSDRGAYDTQYF	NLVPMVATV
CSVGGSGGADTQYF	NLVPMVATV
CASSINSGWGEQFF	other
CASSPRDRPLEQYF	other
CSAPGTGLRDEQFF	NLVPMVATV
CASSYPIAGHSYNEQFF	other
CASSLVGTGELFF	other
CASSLLADSEFRIF	NLVPMVATV
CSVGGQGARCNQPQHF	other
CASSATVNTEAFF	other
CSATRDRGNYGYTF	other
CASSSGSKQNTGELFF	NLVPMVATV
CAIGDENTGELFF	other
CASSQDGTNPYNEQFF	NLVPMVATV
CASETEGVRGGYTF	NLVPMVATV
CAISELSGGEVYF	NLVPMVATV
CAWSVYTSGGDTQYF	NLVPMVATV
CASSYATGTAYGYTF	NLVPMVATV
CAWSGFGSPGETYEQYF	NLVPMVATV
CASSTEETQYF	NLVPMVATV
CASSLGAGRTEAFF	other
CASSFAISAEAFF	other
CASSPGTSGIDSRSYNEQFF	other
CASSFGGYEQYF	NLVPMVATV
CASSWYRGLDYEQYF	NLVPMVATV
CASSLERFTEAFF	NLVPMVATV
CASSTTGTATDGYTF	other
CASSHADRVFTGELFF	NLVPMVATV
CASSLGSGYGYTF	other
CASSIRSSDEQYF	other
CASSNSGRYNEQFF	other
CSARDLEGTAKNIQYF	NLVPMVATV
CASSIRGGGEQFF	other
CASSYTVNYGYTF	other
CASRRLAGSTDTQYF	NLVPMVATV
CSARVDRDYEQYF	other
CASNQVTGTGAYGYTF	NLVPMVATV
CASSLGPPYGYTF	NLVPMVATV
CASSDTYTDTQYF	NLVPMVATV
CASSTRTSGINEQFF	NLVPMVATV
CASSPADPFSNTQYF	other
CASSSPSSRGLETQYF	other
CASSDSLDGYTF	other
CSVEEQNTGELFF	other
CASSFYNEKTVF	NLVPMVATV
CANRDTDTQYF	other
CASSYQAVLSGLSTDTQYF	NLVPMVATV
CASSLAPGATNGKLFF	NLVPMVATV
CASSVRSATEAFF	other
CASSHKQATGRKTYEQYF	other
CASSLGTSPGAEAFF	NLVPMVATV
CASSFLAGGNEQFF	other
CASSIHSGQNTEAFF	other
CASSGWTLRIYEQYF	other
CAWSVILWGRGPTDTQYF	other
CASSLGLEGEQYF	other
CADREFMNTEAFF	other
CSANDRDGLREHF	other
CASSLTYGYEQYF	NLVPMVATV
CASSPWTGIPYNSPLHF	other
CASSLGGNRYEQYF	NLVPMVATV
CSARAGQAGSPLHF	NLVPMVATV
CASSLEGANYGYTF	other
CASSLARGQYSYEQYF	NLVPMVATV
CASTRTISVSDTQYF	NLVPMVATV
CSARGPGAISYEQYF	NLVPMVATV
CASCPDRDTVNEKLFF	other
CASSTGTGVGNEQFF	NLVPMVATV
CSANRVGEQYF	other
CASSSVGKNTEAFF	other
CASRGDGSFRELFF	other
CASGDENTGELFF	other
CATTSDGTANEQFF	other
CASGPTGTDNSPLHF	NLVPMVATV
CATMEGHEQFF	NLVPMVATV
CASTLPEGGSDIEDWTNTDTQYF	other
CASSESTAGRVPSTDTQYF	other
CASSVATEGYGYTF	other
CASSQDQSISYEQYF	NLVPMVATV
CSAIPTGNYEQYF	other
CSARDLGRGWNTGELFF	other
CAISEPPQGPRLAGVFNEQFF	other
CASSIRGLASYNEQFF	other
CASSVEGGYASGANVLTF	NLVPMVATV
CASSFGSGANVLTF	other
CSASLGNQPQHF	NLVPMVATV
CASRASYEQYF	NLVPMVATV
CASSQGLSGGLSYNEQFF	other
CSVGVKNTEAFF	NLVPMVATV
CATSRDLSGRPDTEAFF	other
CASSFPTSGGAEDTQYF	other
CSARGASSYEQYF	NLVPMVATV
CASSDGGGGTAELFF	NLVPMVATV
CASSDSGGATDTQYF	other
CASSEGDTEAFF	other
CSAVGRSYNEQFF	NLVPMVATV
CAISDGSYWDEQYF	NLVPMVATV
CSARDAVAANTGELFF	other
CATSRDRGTGTEAFF	NLVPMVATV
CSAPTSGFYNEQFF	NLVPMVATV
CASSIVGGTEEAFF	other
CATSSYGGSGLGTEAFF	other
CASSIGTNTEAFF	NLVPMVATV
CSARVSGTDFYEQYF	NLVPMVATV
CAAQDSNTGELFF	other
CASSLRGGFSVGYTF	other
CASTGGGLFGYTF	NLVPMVATV
CASSQETDRGYNSPLHF	other
CASSLAGGYYNEQFF	other
CASSMVVIGTEAFF	other
CASSPSSGTGSYEQYF	other
CSAGLPSREMAGELFF	other
CASSLLVSSSYNEQFF	NLVPMVATV
CASSLGQGGIDGSRHEQFF	NLVPMVATV
CASSLYASGDSYNEQFF	other
CASRPDFTGEQYF	other
CASSQEGWTSDETQYF	NLVPMVATV
CSSSTETGELFF	NLVPMVATV
CASSWSGGSHYGYTF	other
CSASNLGAGFYNEQFF	NLVPMVATV
CASSTRGSTGELFF	other
CASSLFSTVPIIVRTEGNTEAFF	NLVPMVATV
CASSQDLGGTYRGNEQFF	NLVPMVATV
CASSPRGRRNTIYF	other
CASGYNTEAFF	NLVPMVATV
CASSLAQGGFYEQYF	other
CSARTDNSPLHF	other
CASSIFSGGANEQFF	other
CASSIVGIGNQPQHF	other
CASSQDGTSGADTQYF	NLVPMVATV
CATTPLIAGAHEQYF	NLVPMVATV
CSLARDTKAFF	other
CSVRGTGPQETQYF	other
CSVEVGQVAEQYF	other
CASTYQAGFYNEQFF	NLVPMVATV
CASSEAYWAGVNTEAFF	NLVPMVATV
CASSLIGQGDPTDTQYF	NLVPMVATV
CSSRPPGGDEQFF	other
CASSLLDSHSYEQYF	NLVPMVATV
CASSPTSGGADTQYF	NLVPMVATV
CSAPRTGRLDTEAFF	other
CATILYEILLGKATLYAVLVSALVLMAMVKF	NLVPMVATV
CVSSIRSAYEQYF	other
CASSSVPTGENTEAFF	NLVPMVATV
CASSPTTGAPAYGYTF	NLVPMVATV
CASSLRSSIEAFF	other
CASSLGTGEGTYNEQFF	NLVPMVATV
CSARQYRTDMNTEAFF	other
CASSLEPGEQFF	NLVPMVATV
CASSQAGMAKQFF	NLVPMVATV
CATSPRTGGDEQYF	NLVPMVATV
CASREGANGYTF	NLVPMVATV
CASSWFSGANVLTF	other
CATSEAPVTSTDTQYF	other
CASSLRQGIRAFF	NLVPMVATV
CASSPLGTLYGYTF	NLVPMVATV
CSVEDGSENTEAFF	NLVPMVATV
CASSLDRAYEQYF	NLVPMVATV
CASTRSWDSNSPLHF	NLVPMVATV
CASSLGGLAGIRSEQFF	other
CSARETGRATNTGELFF	NLVPMVATV
CSVEAQGGTFNEQFF	NLVPMVATV
CASSYAAGELFF	other
CASSLSGEQYF	NLVPMVATV
CASSPALTSGGAVDF	other
CASTGYMNTEAFF	other
CASSTGPRGVNQPQHF	NLVPMVATV
CSARDGQGMNTGELFF	other
CAWQTGVSTGELFF	NLVPMVATV
CASREDYNSPLHF	NLVPMVATV
CASSYTSGNTGELFF	other
CASSQGQGLNGYTF	NLVPMVATV
CASSVGRTSTDTQYF	other
CASSQTQLWEIQYF	NLVPMVATV
CASNPLLGAGGTYNEQFF	NLVPMVATV
CASSHGAEAFF	other
CASSQTLVADTQYF	other
CALGVDRTEAFF	NLVPMVATV
CASRFRRPYGYTF	other
CASSTDTNEQFF	other
CASSMFGQLGYTF	other
CASASEQGTDIQYF	other
CASSFGGDEQHF	other
CASSQVRLNTEAFF	other
CASSPTPAAFF	other
CASSSRQNSGNTIYF	NLVPMVATV
CASSYDRGTGELFF	NLVPMVATV
CASSQEGGQVHIQYF	NLVPMVATV
CSARDPRRKAHEQYF	NLVPMVATV
CASSIYGTGAYEQYF	other
CASSLKRLWQRYGYTF	NLVPMVATV
CSARNDRGDLQMSEKLFF	NLVPMVATV
CATSSVRSGADTQYF	NLVPMVATV
CASKGYEQFF	other
CSARTSGTPGWEQFF	NLVPMVATV
CASSIRSVAEQYF	other
CASSLGGGSGGYTGELFF	other
CAISDRGGPTYEQYF	NLVPMVATV
CASSLSDGTDTQYF	other
CASSLESAGHSNTEAFF	NLVPMVATV
CASSRDRVENEQFF	NLVPMVATV
CASSQLINRDRGLNEQFF	NLVPMVATV
CASSQGGVLAGGDEQYF	other
CASSPQVGSGASYNEQFF	other
CASGGDRVVWTEAFF	NLVPMVATV
CASRSTGLAGYNEQFF	NLVPMVATV
CSARDTISRTSVTDTQYF	other
CASSEHPYPGGEQFF	NLVPMVATV
CSANAFSNQPQHF	other
CASGASGSSEAFF	NLVPMVATV
CSVAGTGNNEKLFF	other
CASSVGGQGDWYEQYF	NLVPMVATV
CASSPAGGGEAFF	other
CPSSVGALSQETQYF	NLVPMVATV
CASSLHGRNYEQYF	other
CASSYGGRNTEAFF	NLVPMVATV
CASSIFSGSYNEQFF	other
CASSPLVGSYNEQFF	other
CASSHRENTEAFF	NLVPMVATV
CSVEYPSGQPMDTQYF	NLVPMVATV
CAWARITEAFF	NLVPMVATV
CASDSGEYQETQYF	NLVPMVATV
CASSITGGAPLAGELFF	NLVPMVATV
CASRTSGTLLYEQYF	NLVPMVATV
CASSFGGNTGELFF	other
CASILAPGATNEKLFF	NLVPMVATV
CASGSSGANVLTF	other
CASSGVLGWVADGTDTQYF	NLVPMVATV
CASLTGAETQYF	other
CASSQVLQGNTGELFF	NLVPMVATV
CAWSGDSYEQYF	NLVPMVATV
CASWGLSYNEQFF	NLVPMVATV
CASSFSQTSGTGRIYYGYTF	other
CASSIRFGTEAFF	other
CSVRLDSSGQPQHF	NLVPMVATV
CASSSTGVDEQFF	other
CASSRSGRDSYNEQFF	NLVPMVATV
CASSLGGYSPLHF	other
CASSTLAEAFF	NLVPMVATV
CASSYRGPSGNTIYF	other
CSARDREQGGEITEAFF	other
CASSLRGLLGYTF	NLVPMVATV
CASTGLNTGELFF	other
CASSRRGLREKLFF	other
CASIAGLVGDTQYF	other
CASSPVTGTGHYGYTF	NLVPMVATV
CASSLTVQSDEQYF	other
CASSETDSNYEQYF	NLVPMVATV
CSARDASGGAGTGELFF	NLVPMVATV
CASSGDRETDTQYF	other
CASSGQLRTPRGEQYF	NLVPMVATV
CASSHGTGGSLVGDTQYF	NLVPMVATV
CASRDPDGDTQYF	other
CASSPTGGSYGYTF	NLVPMVATV
CASSSPFRSGTDTQYF	other
CASSIGQGARGYTF	other
CASSLVPPGLAGSTDTQYF	other
CASSIFEGQETQYF	other
CASSLSRGPYNEQFF	NLVPMVATV
CASSYGPEAHNEQFF	NLVPMVATV
CASSHVWAGTGFVYGYTF	other
CASTNRDRGNSPLHF	NLVPMVATV
CSARGLSDSTHQPQHF	NLVPMVATV
CASLRESPGADGYTF	other
CASSLSGTGFYGYTF	NLVPMVATV
CASSSESPGGSYTF	other
CSARGLSGGDYEQYF	NLVPMVATV
CASSWTANYGYTF	other
CASSLWDRAKANYGYTF	other
CASSPSHHFEAFF	other
CASSELGGGNTGELFF	other
CASSLSGTGGTDTQYF	NLVPMVATV
CAWDSSGTGELFF	NLVPMVATV
CASSLPPEATNEKLFF	NLVPMVATV
CASSPRTSGMSYNEQFF	NLVPMVATV
CASRMGFSNQPQHF	NLVPMVATV
CSAREAWRGRTEAFF	NLVPMVATV
CASSLFGTGGLEAFF	NLVPMVATV
CASSLALVGEQFF	other
CASGGLSTDTQYF	other
CASSITGGNNEQFF	other
CASSFGTWGYTF	other
CASSRLATGQITDTQYF	NLVPMVATV
CASNDLNTGELFF	other
CASSLARYEQYF	NLVPMVATV
CASSLSAEAFF	other
CASTMGALGTGELFF	other
CSVVGTINERFF	NLVPMVATV
CASSRSGRETQYF	other
CASGWGVQGESKSYGYTF	NLVPMVATV
CASSLATGISYEQYF	NLVPMVATV
CASSLTEVSYEQYF	other
CASSTFGTGGNEQFF	other
CASSSRDHGYEQYF	other
CSAIDSLSNEKLFF	NLVPMVATV
CASSIWQNTEAFF	other
CASRRGRNTGELFF	NLVPMVATV
CSAGRKTSGRYQETQYF	other
CASSLPERKYNEQFF	NLVPMVATV
CATSYRSSDTQYF	other
CASSSSGGAYNEQFF	NLVPMVATV
CASMEENTGELFF	other
CASSFWRYEQYF	NLVPMVATV
CASSGGTGTSGRAVEQYF	NLVPMVATV
CASSELTGGGNEQFF	NLVPMVATV
CASSIRRIDPYNEQFF	other
CASSQPGQPQETQYF	NLVPMVATV
CSVLIAEAFF	NLVPMVATV
CASSQGQAYEQYF	other
CASSLSIGGNYGYTF	other
CATTTGTESSNQPQHF	NLVPMVATV
CASSLGSSNQPQHF	other
CASSMTSGPYNEQFF	other
CASSLPLSDSPTHTQYF	NLVPMVATV
CASSRLAGGDEQFF	other
CASSYSRAGANEQFF	NLVPMVATV
CASSISPTGELFF	other
CASTQRIGVEQYF	other
CASSEAYYEQYF	NLVPMVATV
CASSYQRGAGETQYF	NLVPMVATV
CASSLPGISYEQYF	NLVPMVATV
CASSQGFNPGGGYTF	NLVPMVATV
CASSHQAGEVNEQFF	NLVPMVATV
CASSILSGPRTEAFF	other
CASSQGQGRGNTEAFF	other
CASSGYSVDTQYF	other
CASSLAQGTDSYEQYF	NLVPMVATV
CASSFPPGQGPGYNSPLHF	other
CASGTGELFF	NLVPMVATV
CASSQPLTGGRNTGELFF	other
CASSDSYGYTF	other
CASSPAQGQGQFF	NLVPMVATV
CASSLAVGPVTEAFF	NLVPMVATV
CATSRGSGSTDTQYF	other
CATSDRGQGANWDEQFF	other
CASSQADRDTYEQYF	other
CASSSWTSGGSTDTQYF	NLVPMVATV
CQAGDTEAFF	other
CASSIAYEGLRTEAFF	NLVPMVATV
CASSLLGFSDGGTGELFF	other
CATENSGTGDSYEQYF	other
CASSQGFLLGAMETEAFF	NLVPMVATV
CAIQESNTGELFF	other
CASQDRNTGELFF	other
CASSQDAGSSYNEQFF	NLVPMVATV
CASSSRDRASVFSQETQYF	other
CASSEWIQETQYF	other
CASSSQGSTDTQYF	NLVPMVATV
CASTSGQLAPGELFF	other
CASSKARTGELFF	other
CASSFSLPYEQYF	NLVPMVATV
CASSLAEGLYETQYF	NLVPMVATV
CASSPGIGLADYEQYF	NLVPMVATV
CATSDLSQGVDTQYF	other
CASRIAGSNNEQFF	other
CASSFVAGGYNEQFF	other
CAWSEQGLGNEQFF	NLVPMVATV
CSARDTALVNIQYF	NLVPMVATV
CASSSRSQVEQYF	other
CSASGGVSYNEQFF	NLVPMVATV
CASSQDLPGPNTEAFF	other
CASSQRAAHIQYF	other
CASSFDGGEMGRNEQFF	NLVPMVATV
CASSWAMNTEAFF	other
CASSSPLIRQGANYGYTF	other
CSVEMQSSGPYEQYF	NLVPMVATV
CASSLGLNHEQYF	other
CASSPRGRTEAFF	other
CASSPWSAGNEQFF	other
CASSTGTGWNEQFF	other
CASSHVGRTDTQYF	NLVPMVATV
CASSGGLNQPQHF	other
CASSTYGTDTQYF	other
CASSHGEGLAVSYNEQFF	other
CASSSHTGGFGYTF	other
CASSYELRTGVFDTQYF	NLVPMVATV
CASSWSGGSYEQYF	NLVPMVATV
CASSPWTTLHPYESSYEQYF	NLVPMVATV
CAISPGQGIGYGYTF	other
CASSWGTPSYEQYF	other
CASIRLAGEHNEQFF	other
CSVLGVTSTDTQYF	NLVPMVATV
CSALAVYPQESSYNEQFF	other
CASSMRSGDTQYF	other
CASSTHGGNEQFF	other
CASSTRSDSEAFF	other
CASRADTEAFF	NLVPMVATV
CASSGLAGANEQFF	other
CASSSRTSGRFYEQYF	NLVPMVATV
CSGGQGEDTEAFF	NLVPMVATV
CSVDWRADRGETQYF	NLVPMVATV
CASSLGGPSGGYTF	other
CATSGAETHNTGELFF	other
CSVEEGLSFGEQFF	NLVPMVATV
CASSPLKNIQYF	NLVPMVATV
CASSFQGFTEAFF	NLVPMVATV
CASSSRPGELFF	other
CASTPRDREYDTGELFF	other
CASSLNLAGGTYEQYF	other
CATSRDLDNGRQFF	other
CASSQDYQGNYGYTF	NLVPMVATV
CASSLPSGAYGYTF	NLVPMVATV
CASSESETSGYNEQFF	other
CASSIVGVSEQYF	other
CASSFYNEKLFF	NLVPMVATV
CASSQSGAGGPYEQYF	other
CASSIDAGLFSYEQYF	NLVPMVATV
CASSSVNEQLF	NLVPMVATV
CASSQVTGSKETQYF	NLVPMVATV
CASSLVAGQIITDTQYF	NLVPMVATV
CASSLEVTYEQYF	other
CASSQDSYGGLGNTIYF	NLVPMVATV
CAIKYRPRTGENYGYTF	NLVPMVATV
CASSPPDRANTGELFF	NLVPMVATV
CASSKTGTNTDTQYF	NLVPMVATV
CSVGRGYEGYTF	NLVPMVATV
CASSQSQALAGDEQYF	NLVPMVATV
CASSSQGGEELFF	NLVPMVATV
CASSVRTTGSTDTQYF	NLVPMVATV
CSAYRDRGLTEAFF	other
CSARDPTSYEQYF	NLVPMVATV
CASSEAPRVPWWGTGVGLNYGYTF	other
CASSLVLWSSNTEAFF	other
CSARDYFADTQYF	NLVPMVATV
CASSISSTDTQYF	other
CASSFPGLQPQHF	other
CSARGESDQNTGELFF	other
CASSSGSPSFEQYF	NLVPMVATV
CASSIRATDTQYF	other
CATSLQGFGQPQHF	other
CASSPLAGADTQYF	NLVPMVATV
CSARRGEYNEQFF	NLVPMVATV
CASSQDLGGSKTQYF	NLVPMVATV
CASTTGTGGGEQYF	other
CSADPQAQFF	NLVPMVATV
CASSYWQGELFF	other
CASSPNRAGNYGYTF	NLVPMVATV
CASSVAAGGPDEQFF	NLVPMVATV
CASSHTVSGGSNEQFF	NLVPMVATV
CASNLAGHTDTQYF	other
CASSPRGGRTGELFF	NLVPMVATV
CASSLTGLGQPQHF	other
CASSLDPGSSGANVLTF	NLVPMVATV
CASSWISSGANVLTF	other
CASSITPNTEAFF	other
CASSWAGPVEQYF	other
CASSSDIEQFF	other
CASSQAGIAEQFF	NLVPMVATV
CASGLIYPGELFF	other
CASSLPPGATNEKLFF	NLVPMVATV
CASSLRTGPGYEQYF	other
CASSDKARGGYTF	NLVPMVATV
CSARDWTGNGYTF	other
CSAHRVPYEQYF	other
CSARSLPRATDTQYF	NLVPMVATV
CSVEDFRAEAFF	NLVPMVATV
CATSRDPGGAYEQYF	NLVPMVATV
CASATGGLYEQYF	NLVPMVATV
CASSARSQETQYF	other
CAWSGVGGASPLHF	other
CASTYGTQYSYGYTF	other
CASSLEVGRPDTEAFF	NLVPMVATV
CASSPGQGPYEQYF	NLVPMVATV
CASSQAWRDTQYF	other
CASSLAGEGGNTIYF	other
CASRLLGQETQYF	NLVPMVATV
CASSSPGQGAGETQYF	NLVPMVATV
CASMNRGTEAFF	other
CASSYPAAGHSNQPQHF	other
CASRDNPPYEQYF	NLVPMVATV
CAWSGDRAMVSGELFF	other
CSARDDGQGQGARTYNSPLHF	NLVPMVATV
CASGGAVAFF	NLVPMVATV
CASSLSGTMNTEAFF	NLVPMVATV
CASSSFWTGLDEKLFF	other
CASTISAEQYF	NLVPMVATV
CASSLFRGPEAFF	NLVPMVATV
CASTTIHGGVTDYGYTF	other
CATTEGGGGGADEQFF	NLVPMVATV
CASSFTSGGVTDTQYF	NLVPMVATV
CASSSGGNEAFF	NLVPMVATV
CASSQDPGPNSNQPQHF	NLVPMVATV
CASSYRSAYEQYF	other
CASSFSDFGNEQYF	other
CSANPSGAYEQYF	NLVPMVATV
CASSFRGVNTGELFF	NLVPMVATV
CASSYGDSYEQYF	other
CASNEAGVDNEQFF	other
CSVDWTGDSGNTIYF	NLVPMVATV
CSARTGDLQYF	NLVPMVATV
CASSLRAGDGYTF	other
CASNGQVAFYNEQFF	NLVPMVATV
CASSQGYAGIWYF	NLVPMVATV
CASSGRGLNTEAFF	NLVPMVATV
CASSLGGVVDTQYF	other
CRAEEGERGMRSYNEQFF	other
CASSRAGLPHEQYF	other
CASSSPRRGIQETQYF	other
CASSLAPGGVKDTQYF	other
CASSFFQGVGEQYF	other
CASRPITGDLCPYEQYF	NLVPMVATV
CASSAVWGYEQYF	other
CASSLNGGADEQYF	other
CASSEGSTDTQYF	NLVPMVATV
CASRGLDYYNEQFF	other
CASSYGQGVGYGYTF	NLVPMVATV
CSARRGDTYEQYF	other
CASSQSPGGVEFF	other
CASSHRFNEQFF	NLVPMVATV
CASSSGGWGEQYF	NLVPMVATV
CSVEGQQTYEQYF	NLVPMVATV
CASSLEATRYNEQFF	NLVPMVATV
CASSPRGRTGFITEAFF	NLVPMVATV
CASSPRQGSYNEQFF	NLVPMVATV
CASGLTVGRRDEQFF	other
CASSFPAGNEQFF	other
CASRLGQLYEQYF	NLVPMVATV
CASSLLPDPTFFDEQFF	NLVPMVATV
CASLQGRTEAFF	NLVPMVATV
CASSVDRGVTYEQYF	NLVPMVATV
CASNLGGPNQPQHF	NLVPMVATV
CASSAVQGDTQYF	other
CASSPRQDEQFF	NLVPMVATV
CASSLVPEEQYF	other
CATSSGDLSSGANVLTF	other
CASSRGTGELFF	NLVPMVATV
CASSNRSGETQYF	other
CASRDSRGTEAFF	NLVPMVATV
CASPEANTGELFF	other
CASRPPGVYEQYF	NLVPMVATV
CASSEGQNYGYTF	other
CASSFTSSRTDTQYF	NLVPMVATV
CASSINTFGDEQYF	other
CASSGGGGEKLFF	other
CASSPDREETQYF	other
CASSPTGGEGGYTF	other
CASSVGLGRGYEQYF	other
CASSFLAGAHTDTQYF	other
CASSLYDSYNEQFF	other
CASSSGTWNTEAFF	other
CASSWGWGGEEQYF	other
CASSPDGEQYF	other
CATSDQSREQYF	other
CASRPGVMNTEAFF	NLVPMVATV
CASSFNDEQFF	other
CASSIFDSSNQPQHF	other
CSAKKGGGDTDTQYF	other
CASSALPEAFF	other
CASSSPAESRVGEQYF	NLVPMVATV
CASSYSVAPEQFF	NLVPMVATV
CASGTDRGTPYEQYF	NLVPMVATV
CSAGILTSGSSYEQYF	NLVPMVATV
CASSIGGTGGLPQHF	NLVPMVATV
CASSSRSGSEQFF	other
CASSPNWRDGSGANVLTF	other
CASSRFLGSGGAAEQFF	other
CASSLSVGGIEQFF	NLVPMVATV
CASSLGPLEQYF	NLVPMVATV
CASSSINEQFF	NLVPMVATV
CASRLVGIGNSPLHF	other
CASSPRVNTEAFF	other
CATSRGGEDTGELFF	other
CASSEAARATGELFF	NLVPMVATV
CASSHQTGQGETQYF	NLVPMVATV
CASSEGRSYEQYF	other
CASSQDPTGYYGYTF	other
CASSNGQYSNQPQHF	other
CSARALGLAGANTGELFF	NLVPMVATV
CASSQGPGMVPQYF	NLVPMVATV
CASSLDHTNEQFF	NLVPMVATV
CILPVGQVLSYEQYF	NLVPMVATV
CASSSAYYDYTF	NLVPMVATV
CASSIQREGGTDTQYF	NLVPMVATV
CASSFGADTQYF	other
CASNRGDGYTF	other
CASSYSGTGNEQFF	other
CASSSGQGNQPQHF	other
CASQLMNTGELFF	other
CASSSRAVDEQYF	other
CATSGYLLDRSTDTQYF	other
CSVEGPMSYEQYF	other
CSVNRGFYGYTF	other
CSARELGTANTEAFF	NLVPMVATV
CASSGNTGELFF	other
CASSLVGEGRTEAFF	other
CASSLWGNQPQHF	NLVPMVATV
CASSGGSTDTQYF	NLVPMVATV
CASSFVGPTNSPLHF	NLVPMVATV
CASSDPAGNTIYF	other
CASSLLDGQGARYGYTF	NLVPMVATV
CASSQGTGLDGNEQFF	NLVPMVATV
CASSQGDPSGTQYF	other
CASTSKKGINEQYF	other
CATSRDRTGGNEQFF	other
CASSTGGLLYEQYF	other
CASSPWDRGLAEAFF	other
CASSWDRNNEQFF	other
CATTGIGGKTQYF	NLVPMVATV
CATSRDKGGATTGELFF	NLVPMVATV
CASSGDTYNEQFF	other
CASSFTGRSPLHF	NLVPMVATV
CASSYRQVSETQYF	NLVPMVATV
CASSWHLKETQYF	other
CASSLGPGSEAFF	other
CASSYSVPSGRGEQFF	NLVPMVATV
CASSGTSGGYNEQFF	NLVPMVATV
CASSSTGASNSPLHF	other
CSVDRDGRTF	other
CASSLSGGALNEQFF	NLVPMVATV
CASSILATDTQYF	other
CASTERVAKNIQYF	NLVPMVATV
CASSLVTSGSYNEQFF	other
CASSQGLADGTDTQYF	other
CASSQEGWYEQYF	NLVPMVATV
CSAIAPSQGADSIQYF	NLVPMVATV
CASSLGAGGEQFF	other
CASSAGQGGVSETQYF	NLVPMVATV
CSARQGLGTEAFF	other
CSAWDYGYTF	other
CASSQETQYF	other
CASSIGRTEAFF	NLVPMVATV
CSARDHCGVSVGETQYF	NLVPMVATV
CSARDYRQTNTGELFF	other
CASSIPATPTDTQYF	NLVPMVATV
CASSDTGQGVDTQYF	NLVPMVATV
CASSDPGNQPQHF	NLVPMVATV
CASSTRSGTEQFF	other
CASRLLAGGSSIQYF	NLVPMVATV
CAWSPPGPEQFF	NLVPMVATV
CSARGGGSFYEQYF	NLVPMVATV
CASSPTGVGTQYF	other
CASSESLGNTGELFF	NLVPMVATV
CASSRTANTGELFF	other
CASRQLQGITDTQYF	NLVPMVATV
CSASYGRGPYNEQFF	NLVPMVATV
CASSLTAGGGETQYF	other
CASSPISPGQGAFGELFF	other
CASSSRGSDTQYF	other
CASSETRSGTWDEQFF	NLVPMVATV
CAWSLRDAGELFF	NLVPMVATV
CASRYRGPVGEQYF	NLVPMVATV
CASSGGSVNNEQFF	NLVPMVATV
CASSEDREVSEQYF	NLVPMVATV
CASSPATGSNQPQHF	other
CASSPGTGEQYF	other
CASSLFYLEDEQFF	other
CASSQGGGGTYEQYF	other
CSARGQDIYEQYF	NLVPMVATV
CASSQDIGAGEQFF	NLVPMVATV
CASSDLDGGEAFF	other
CASSLGPEAFF	NLVPMVATV
CASGGRNYNEQFF	NLVPMVATV
CASSFSSTDTQYF	other
CASSQGTSIGETQYF	other
CASSGHWGYYGYTF	other
CASSVGGDPYNEQFF	NLVPMVATV
CASSLAPQETQYF	NLVPMVATV
CASSLGFPGTFFYEQYF	NLVPMVATV
CAISDGTGVSPLHF	NLVPMVATV
CASSSDWSKDNEQFF	NLVPMVATV
CASSLVHYNSPLHF	NLVPMVATV
CASSYLFGDANTGELFF	other
CASSLDRGEQYF	NLVPMVATV
CASSDLSTDTQYF	other
CASTPGVGGRSRYNEQFF	NLVPMVATV
CATSDFCRPQADNSPLHF	other
CASTGLAGTHSYNEQFF	NLVPMVATV
CSAIRTGGHNSPLHF	NLVPMVATV
CATSRGAGTSTDTQYF	NLVPMVATV
CASSRYLGGGETQYF	other
CASSPQGTSGFTGELFF	NLVPMVATV
CASSTTGANTEAFF	NLVPMVATV
CASSENTGTGGNYGYTF	other
CASSTGSGNQPQHF	other
CAGDYLNTGELFF	other
CASSQPSSGGVTGELFF	other
CASSAAGGGGHTDTQYF	NLVPMVATV
CASSIFGGQGSYNEQFF	other
CASSSRSSETQYF	other
CASSIFDSAREQFF	other
CATSEHDSTGELFF	NLVPMVATV
CASSSREGSGRERNTEAFF	NLVPMVATV
CASSSRHEGEDTEAFF	other
CASSILSLDTQYF	other
CASGLGDRVVDEQFF	NLVPMVATV
CASRSGAETFF	other
CASGGYNEQFF	NLVPMVATV
CSAPSGTSTDTQYF	NLVPMVATV
CASSIYSTDTQYF	other
CASSPRTGRDTEAFF	NLVPMVATV
CASSEVGQGARYNEQFF	other
CSARAAGGQDTQYF	NLVPMVATV
CASSITLGTGGVEQYF	NLVPMVATV
CSARDERVIPNTGELFF	NLVPMVATV
CASSLFRGPETQYF	other
CASSVEGGGAKETQYF	other
CSARDPGQLVSGNTIYF	other
CASSHWRGTDTQYF	other
CASRMGGKNTEAFF	NLVPMVATV
CALGSSNTGELFF	other
CAISPSSEQYF	NLVPMVATV
CASSIYGGSYNEQFF	other
CASTWTGVGYNEQFF	NLVPMVATV
CGASGVSSYEQYF	NLVPMVATV
CASSPGTNDEKLFF	NLVPMVATV
CASRDAGGTEAFF	NLVPMVATV
CASRPKSPLHF	other
CASSPSDFGTDTQYF	other
CASSYSTVRDESFATDTQYF	other
CASSGGGPTNEKLFF	other
CASSPQGVGYNQPQHF	NLVPMVATV
CASRTRGGMNTEAFF	NLVPMVATV
CAWSVLFGANSYEQYF	NLVPMVATV
CATSRTGAHEQYF	NLVPMVATV
CASSKGGRGGPETQYF	other
CSASRPAGTTPREAFF	NLVPMVATV
CASSLVSRGDTQYF	other
CASSVPGQSNTEAFF	other
CASSPTGYYNEQFF	other
CASSADVEAFF	other
CASSPGLAAGELFF	other
CASSLDGGGGNTIYF	other
CASSQVVVGGRDPYEQYF	NLVPMVATV
CASSLAGTSTEQFF	other
CASRSGNYGEQYF	other
CASSMFDSSYEQYF	other
CASSLTSNTEAFF	NLVPMVATV
CASSPGDIQETQYF	other
CSVVSNYGYTF	NLVPMVATV
CASSPEGSAGSGANVLTF	NLVPMVATV
CASSINSYSGNTIYF	other
CATQSGNEKLFF	other
CASSTNLGHKEQYF	NLVPMVATV
CASSPRRVGTDTQYF	NLVPMVATV
CSARRDTNEQFF	other
CASSFEGASVGIQYF	other
CASSQDLAGVGNQPQHF	other
CASSVAEGGEAFF	NLVPMVATV
CASSEIGWGEQYF	NLVPMVATV
CSANSGEGGTTDTQYF	other
CASSFGSGRWLNEQFF	other
CASSLKQAGGAKNIQYF	other
CASSSRSSTEAFF	other
CASSLGGWNTEAFF	NLVPMVATV
CASSLGVAYQETQYF	other
CASSRDRGYEQYF	NLVPMVATV
CAINSGGSTDTQYF	other
CASSLGTGDTGELFF	NLVPMVATV
CASSDLGREQFF	NLVPMVATV
CASSHGGSGGYTF	NLVPMVATV
CASVGGNYGYTF	other
CASSLSGQETQYF	other
CASSQDGGLGTDTQYF	NLVPMVATV
CASSSTGTGGRAYNEQFF	NLVPMVATV
CASSDSSVSEQFF	other
CASSGGTDPSWDGYTF	NLVPMVATV
CASSQEGAGITEAFF	other
CSVEDWDRRQETQYF	other
CASSLLQGGLNTGELFF	NLVPMVATV
CASRGGGRTSYEQYF	NLVPMVATV
CASSQARGNYEQYF	NLVPMVATV
CASSLAPGAANEKLFF	NLVPMVATV
CASSTGSYGCTF	other
CSVQGPSPEAFF	NLVPMVATV
CASSLDLGARGYTF	NLVPMVATV
CASSSLNTGELFF	other
CASSLSGSWTEAFF	NLVPMVATV
CASSPDTTETQYF	NLVPMVATV
CSAGDRGYEQYF	NLVPMVATV
CASSPGLVRYEQYF	NLVPMVATV
CASGSGGRSYNEQFF	other
CASSSWSVNTEAFF	NLVPMVATV
CASSPVKYTIYF	other
CATSLTGSINQPQHF	other
CSARTDRGGQSEAFF	NLVPMVATV
CATSRDRARAVNSLIGELFF	NLVPMVATV
CASSVEGETQYF	other
CASSLPRVGELFF	NLVPMVATV
CASSILVTSEQYF	other
CASSGLSSGNTIYF	other
CASSFTSGGGYEQFF	NLVPMVATV
CASSRSSYEQYF	other
CSAPRLEYNEQFF	other
CSARGGGDLYEQYF	NLVPMVATV
CASSSSLSTDTQYF	other
CASSLGPNTGELFF	NLVPMVATV
CSDTLKTGASYNEQFF	other
CASSYDSGSSYEQYF	NLVPMVATV
CASSQGGGGAEEQFF	NLVPMVATV
CASSSGETDTQYF	NLVPMVATV
CASSGGRVLTANTGELFF	NLVPMVATV
CASSVTGGFTDTQYF	NLVPMVATV
CASSTPGSGNQPQHF	other
CASSDSGAREGTGELFF	other
CASSWGTGTGELFF	NLVPMVATV
CASRMASGETQYF	other
CATSDFTAAEGYTF	NLVPMVATV
CASSLTGANVLTF	NLVPMVATV
CASSLGQGATF	other
CASSPQQSSYEQYF	NLVPMVATV
CASSLTSGGPGDTQYF	other
CSAGRTDTEAFF	NLVPMVATV
CASNADRDYPGELFF	NLVPMVATV
CASSSQRNTEAFF	other
CASSWSGAGEQFF	other
CASSVGVEQFF	other
CASSPGLAGLTDTQYF	NLVPMVATV
CASSLSDSLPSYEQYF	other
CASSMGLYGYTF	other
CASTRTGFTGPYGYTF	other
CSARDGFYGYTF	NLVPMVATV
CASSTRSTHEQYF	other
CASSLEAGLDGYTF	NLVPMVATV
CATSDFLTGEAFF	other
CASSGTVNYGYTF	NLVPMVATV
CASSLLGGWSEAFF	other
CASNWADYSNQPQHF	NLVPMVATV
CASRDWEGYEQFF	NLVPMVATV
CASSLASRLEQFF	NLVPMVATV
CASSPPGGSGNTIYF	other
CASSLETGGGNEKLFF	other
CASSLSGVSSYNEQFF	NLVPMVATV
CASSPLAGYYNEQFF	other
CASSLHRTMTGIDYGYTF	NLVPMVATV
CASSQGTGEAGELFF	NLVPMVATV
CASGYSAGYNSPLHF	NLVPMVATV
CASSNGAYGYTF	other
CSVDRENTGELFF	NLVPMVATV
CASSLGTGYQPQHF	other
CAWSVLFGGRSYEQYF	NLVPMVATV
CASSEASGSGANVLTF	NLVPMVATV
CASSEYRVVPDTQYF	other
CATSGTVPGRTEAFF	NLVPMVATV
CASSTEREAPYEQYF	other
CASSLGISYEQYF	NLVPMVATV
CATSRGFAQQETQYF	NLVPMVATV
CASSTGQDYQPQHF	NLVPMVATV
CASSLLPPGQGRNQPQHF	other
CASSFRDRGLGEQFF	other
CASSLWRGSYNEQFF	NLVPMVATV
CASSIFSGANVLTF	other
CAINTDRGGTEAFF	NLVPMVATV
CASSLQRELGNEQFF	NLVPMVATV
CASRERSYNGEQFF	other
CASSQGSKGINNEQFF	other
CSASSGGASDTQYF	other
CASSYGMGVGDRDTQYF	other
CASSIRSTDAQYF	other
CASTGQLSGNTIYF	other
CASSLSGSYNEQFF	other
CSVGQGNGYTF	NLVPMVATV
CASRPGWASHYNEQFF	NLVPMVATV
CASSQTENTGELFF	NLVPMVATV
CASSLGSGELFF	NLVPMVATV
CASSLGSKQNTGELFF	NLVPMVATV
CASSNHGAYEQYF	other
CSAQDRDKEDTEAFF	NLVPMVATV
CASSVNMEGTYGYTF	NLVPMVATV
CASSLDYEQFF	NLVPMVATV
CASSIRSGPEAFF	other
CATSGGGVRNEQFF	other
CASSADIEQFF	other
CAWSGGQIMNTEAFF	other
CSAHGGQGRAYEQYF	other
CASSTRGSNEQFF	other
CGSSQAGMAEQFF	NLVPMVATV
CSARGFQPYEQYF	NLVPMVATV
CSASLGFEETQYF	other
CASSYARTPLHF	other
CASSDLTGGEAFF	other
CASSFWGTGYNEQFF	other
CASSQDPNYGTGHLMNTEAFF	NLVPMVATV
CSARDLAAYNSPLHF	NLVPMVATV
CASSYRNSLEQFF	other
CATSPTGVNTDTQYF	NLVPMVATV
CASSQESRDYGYTF	NLVPMVATV
CATSRDLGGADTQYF	NLVPMVATV
CASSPTTGASYGYTF	NLVPMVATV
CASSLGTQTYEQYF	other
CASSSGGREQYF	other
CASSFSGGAVSPLHF	NLVPMVATV
CASMPIQDTTWTDTQYF	NLVPMVATV
CSVEDSGNEQFF	other
CASSPPASGELFF	NLVPMVATV
CASRADGSAYNEQFF	NLVPMVATV
CASSLSRGQTSYEQYF	NLVPMVATV
CSAISSGANVLTF	other
CASSTDIEAFF	other
CASSPDIVAFF	other
CASSVGTTPGELFF	other
CASSYSMRGTSTDTQYF	NLVPMVATV
CASSRTTGLEQFF	NLVPMVATV
CASSQDLEGEGYNEQFF	other
CASSIRSSWKLFF	other
CASTDTTYEQYF	NLVPMVATV
CASSYGAGEDTQYF	other
CASSLGSQIYGYTF	NLVPMVATV
CASSSDNEQFF	NLVPMVATV
CASSLGGTESYEQYF	other
CSVEELDRRYGYTF	other
CASSDSAGGTDTQYF	other
CASSLRGPTYEQYF	other
CASSYSGPYEQYF	NLVPMVATV
CSARDQWAANTGELFF	other
CASSIRGSQPQHF	other
CAISAGAEAHEQYF	NLVPMVATV
CASSPEGLLGAFF	NLVPMVATV
CASSLLGAEAFF	NLVPMVATV
CASSLGDFTYEQYF	other
CSVDPRLPGLTNNEQFF	NLVPMVATV
CASSVVGGTDEQYF	NLVPMVATV
CASRDGGQIDETQHF	NLVPMVATV
CSGGLAGGPDPYNEQFF	NLVPMVATV
CASSLARVNYGYTF	other
CASSRLATSGELFF	other
CASSSGVGADTQYF	NLVPMVATV
CATSDSVNRGTPYEQYF	NLVPMVATV
CASRPGRTHLNTEAFF	NLVPMVATV
CASSLVGSSYEQYF	NLVPMVATV
CASSHEDSGGYTF	NLVPMVATV
CASSYSSPETGGQPQHF	other
CASSSWGTANTEAFF	NLVPMVATV
CSVEGLADLTSYNEQFF	NLVPMVATV
CASSMRGADTQYF	other
CASSIQSYNEQFF	other
CASSPQGINYGYTF	other
CSVTSRGGTREQYF	NLVPMVATV
CASSEGLGGEQYF	other
CASSIYGSPTNTQYF	other
CSATDFPNSYEQYF	NLVPMVATV
CASSDSGTLNTEAFF	NLVPMVATV
CASRGSVGLAKKLFF	NLVPMVATV
CAWGRNTEAFF	other
CASSGEQGFYEQYF	NLVPMVATV
CSVGPGDNYGYTF	other
CASSEDRGHWNEQFF	NLVPMVATV
CASSQVGQAIYGYTF	NLVPMVATV
CASSWGKGILDF	other
CASSFGQGGGYTF	NLVPMVATV
CASSFNPSYEQYF	other
CASSQVGTGYNEQFF	other
CSAPVPPYNEQFF	other
CASNLAPGATNEKLFF	NLVPMVATV
CASGTANTGELFF	other
CASRDSGEQYF	NLVPMVATV
CASSVFSVPGNTIYF	other
CASTSGPALYNEQFF	NLVPMVATV
CATILYEILLGKATLYAVLVSALVLMATNEKLFF	NLVPMVATV
CSARNSGDSYEQYF	other
CATSADRDRSYEQYF	NLVPMVATV
CATTTEANTGELFF	NLVPMVATV
CASSDSEGDTDTQYF	other
CASSFMGQGGSYTF	other
CASSLGRLAGGQETQYF	other
CASSFSGTQYF	NLVPMVATV
CATSRIPGGVTDTQYF	NLVPMVATV
CASSIFWQSNTEAFF	other
CATSDDDYNEQFF	NLVPMVATV
CASSLNSSSYEQYF	other
CASANVGLNTEAFF	other
CSARPGLSDEQYF	NLVPMVATV
CASSTRSTDTQHF	other
CASISSGGWQETQYF	NLVPMVATV
CSALNRGDDSPLHF	other
CAGGGMGTEAFF	other
CASSQDRGSGSPYNEQFF	NLVPMVATV
CASSQTQLWEAQYF	NLVPMVATV
CASSPGGDPDTQYF	NLVPMVATV
CSVVPTSGANVLTF	other
CASSPPSSYEQYF	NLVPMVATV
CSGWQPQHF	other
CASSQDPNTGELFF	other
CASSSRSGTEAFF	other
CASSLGIGDRGLGYTF	NLVPMVATV
CASSPGLASYNEQFF	other
CASSQVSGPDTQYF	other
CASSLMGGTYSNQPQHF	NLVPMVATV
CASSLDSPRTDTQYF	NLVPMVATV
CSGFGDRGNTDTQYF	other
CASGGSPQHEQYF	NLVPMVATV
CASSPTGTQETQYF	other
CSARPGQTYEQYF	NLVPMVATV
CATNNFAGGNEQFF	other
CASRQTGGTGNEQFF	other
CSAWDRTEAFF	other
CAWTPGTSVNNEQFF	other
CASSLDGYEQHF	NLVPMVATV
CSVAGTGDLNQPQHF	other
CAPGDLNTGELFF	other
CASSLFPGADGYTF	NLVPMVATV
CASSLGPDLNTEAFF	NLVPMVATV
CSAERTGTSGSNEQFF	NLVPMVATV
CASSEPLGGTSYNEQFF	other
CASSLVTSGGSEQFF	other
CASSTPPGTPYGEQFF	NLVPMVATV
CTSSMRSSGTQYF	other
CSARDMAGFHEQYF	NLVPMVATV
CASSIRSGWEQFF	other
CASRKTGYTGELFF	other
CASSPLLGGHQPQHF	other
CASSIRAGTEQFF	other
CASSFLAGGITDTQYF	other
CASSLFGTHQETQYF	other
CASSSPGHEQFF	other
CAIGDSSSYNEQFF	NLVPMVATV
CASSLWEKLAKNIQYF	other
CSVWRDNYNEQFF	NLVPMVATV
CASSIIGSFDNEQFF	other
CATQDRNTGELFF	other
CATSGRTGELFF	other
CASSLAFRQRETDTQYF	other
CALGQDSYEQYF	NLVPMVATV
CSARGSGAQETQYF	other
CASSETSTDTQYF	NLVPMVATV
CASYSGRALTEAFF	other
CASSQVIDQETQYF	NLVPMVATV
CASSSGPSDEQYF	other
CASSVEQGAPTVETQYF	NLVPMVATV
CASSYSAEADTQYF	other
CAWKGLGYSYEQYF	other
CASSHTNTGELFF	other
CSVEGGTDYENTEAFF	NLVPMVATV
CASSLAPGVTNEKLFF	NLVPMVATV
CAISADSPAAQYF	NLVPMVATV
CASSLGAEEQYF	NLVPMVATV
CASSLLVGSGANVLTF	NLVPMVATV
CASSVSGSTDTQYF	other
CASRYQGGEQFF	NLVPMVATV
CASTIMGSGNTIYF	other
CSADQGEHYNEQFF	other
CASSTLDRATTGELFF	other
CASSSDWDTEAFF	other
CASRSGSYNEQFF	NLVPMVATV
CAWSGEGDPTDTQYF	NLVPMVATV
CSASTYVTYEQYF	other
CASSSTGETQYF	other
CASSGGYEHNEQFF	other
CASSEGVMVTEAFF	NLVPMVATV
CSVGSTGGTNEKLFF	other
CSVVDPPGVNEQFF	NLVPMVATV
CSARTCF	other
CASSQGGGGFEQYF	other
CASSLASGTDSYEQYF	NLVPMVATV
CASQDSNTGELFF	other
CASSQDRPTITDTQYF	other
CASSISGSGNEQFF	other
CASSWWDTGELFF	other
CASSLGGALDIQYF	NLVPMVATV
CAGGDSNTGELFF	other
CASSIYGSYEQYF	other
CASSYGTGGRYEQYF	NLVPMVATV
CASTQRSATQEYF	other
CASQREGINTQYF	NLVPMVATV
CASSLERSNTEAFF	other
CASSGGQPYNEQFF	other
CASSLGDTWYGYTF	NLVPMVATV
CSASGFGLGYTF	NLVPMVATV
CASSAYRDIPEAFF	other
CASSIVGGNYNEQFF	other
CASSLFEETQYF	other
CASSYVGLGSPLHF	NLVPMVATV
CATSTGGTEAFF	NLVPMVATV
CSVEGSLGRALRANEQFF	other
CASILGAGSLNTEAFF	NLVPMVATV
CASSFPGALNEQYF	NLVPMVATV
CASSLGGEGSGYTF	NLVPMVATV
CASSHGSYGYTF	other
CASSFGGGQGTQYF	other
CASRVTSGGRDEQFF	other
CASSSETELLYYGYTF	NLVPMVATV
CASSPGQGTGEQYF	other
CASSLSESSYNEQFF	other
CASSQVIGNSPLHF	NLVPMVATV
CASSQEQGAPGELFF	other
CASSPRWLAGHSTDTQYF	other
CASSQGEEETFF	other
CASSIYRGSYNEQFF	other
CASSPVGVGEQYF	other
CASSQGLAGAGELFF	other
CASASAGGPYNEQFF	NLVPMVATV
CASSLGSGGPNEQFF	NLVPMVATV
CSAADGFSYEQYF	NLVPMVATV
CSAWQGGTDTQYF	NLVPMVATV
CASSQGWSGSFHFEQFF	other
CASSLDILAFF	other
CASSEAEWTSWGYNEQFF	NLVPMVATV
CASSLRAGEVEQFF	other
CASRREDTDTQYF	NLVPMVATV
CASSLFRGPNEQYF	other
CASWSRRRRQYF	other
CASSLGNEQFF	NLVPMVATV
CASSLYASGGATDTQYF	other
CASIPLAGPFNEQFF	other
CASNPQGSNQPQHF	NLVPMVATV
CASSLTSGGHSSYNEQFF	NLVPMVATV
CASSPVLSYNEQFF	NLVPMVATV
CASSLGRGQFF	other
CSARTGGGDTEAFF	NLVPMVATV
CASSFGRVGGYTF	other
CASSSYLTAPTDTQYF	other
CASSQGQLNTGELFF	other
CASSIRFSGANVLTF	other
CASSHSGQSTGELFF	other
CATSSQRGLASYEQYF	NLVPMVATV
CASSQDGGSSYNEQFF	other
CASTVETGELFF	NLVPMVATV
CSVESGMGTEAFF	other
CAWLDDYTSTDTQYF	NLVPMVATV
CASSSAYCGYTF	NLVPMVATV
CASSLFPHTEAFF	NLVPMVATV
CASSTSSTGELFF	other
CASSLVGEPIQETQYF	NLVPMVATV
CASSQVAREDEKLFF	NLVPMVATV
CASSWGGQVAFF	NLVPMVATV
CASSPSHGGLYEQYF	other
CASSLYQGSYEQYF	NLVPMVATV
CASSWGSYGYTF	other
CASSLRLLQETQYF	other
CAWSTGGTQPQHF	NLVPMVATV
CASSYGQGAHTEAFF	other
CASRAGGAREQYF	other
CASSLGREGQDTQYF	NLVPMVATV
CASCAGGQGSDTQYF	NLVPMVATV
CASSLSPEGFSEQYF	other
CSARPPDASGYTF	NLVPMVATV
CASSFGLEMNEQFF	NLVPMVATV
CASGYTGELFF	other
CASSAIRDSFYEQYF	NLVPMVATV
CASSQYAGQQEFF	other
CATSRVNQPQHF	other
CASSSRGQSNQPQHF	other
CSARDLGGGAMETQYF	other
CASSLSSQSYEQYF	NLVPMVATV
CASSLGILTDTQYF	other
CSARDVETKNTGELFF	NLVPMVATV
CASSISTGNEQFF	NLVPMVATV
CSAIEYSGPEGQIYEQYF	NLVPMVATV
CATSEGRGLGYTF	NLVPMVATV
CASSVGVAEAFF	other
CASSLRGGTGDGYTF	NLVPMVATV
CASSPNGGAGGPGNEQFF	other
CASSLGQGSFLNQPQHF	other
CASGTSYTDTQYF	other
CASMSFSSGANVLTF	NLVPMVATV
CASRSSGGFWNEQFF	NLVPMVATV
CASSLRDGTSRTGWETQYF	other
CASSQSREGSPLHF	other
CASSQDPSGGFAYEQYF	other
CASSEGTVSNEKLFF	other
CAISEGASGYTF	NLVPMVATV
CASTPLGGTSYEQYF	NLVPMVATV
CATSTSQDLNQPQHF	NLVPMVATV
CASSSRSSNEQFF	other
CASSDRGWNEAFF	other
CASETGRRFYEQYF	other
CASNPRRDTGYEQYF	NLVPMVATV
CASSLEVAGGGYGYTF	NLVPMVATV
CACTPEIGNTIYF	NLVPMVATV
CASSPLAGGLNEQFF	other
CSARDTTNSYYTDTQYF	other
CASSFQGVFTEAFF	other
CASSQVGDNGDGYTF	NLVPMVATV
CASRGLTSGSSTDTQYF	NLVPMVATV
CASSPKDDYEQYF	other
CASSLMDTDTQYF	NLVPMVATV
CASSQDRREQYF	other
CASSLEGPRSGSIWELFF	NLVPMVATV
CASSFGHSQETQYF	NLVPMVATV
CASSPRLDGNTEAFF	NLVPMVATV
CAIRDNSYNEQFF	NLVPMVATV
CASSPDGAFF	other
CASSPGGSEQYF	NLVPMVATV
CASSLRGPGYEQYF	NLVPMVATV
CASSDPSGFVNEAFF	NLVPMVATV
CASSQDVTAGANVLTF	other
CSARDERFANYGYTF	NLVPMVATV
CASSIHSGANNEQFF	other
CASSPPPGTTYEQYF	NLVPMVATV
CASSNHTRFTDTQYF	NLVPMVATV
CASSIVAPSYEQYF	other
CANDRGAPNQPQHF	NLVPMVATV
CASSINSGGIYNEQFF	other
CASSFETFGSGELFF	other
CASSLDRVANTEAFF	NLVPMVATV
CASSLAANTGELFF	NLVPMVATV
CASSIRSSYKQYF	other
CASSNSYEQYF	other
CAWSLAGMGETQYF	other
CASSYSGQLNEKLFF	other
CASMGLGNTIYF	NLVPMVATV
CASSYQTGAVYGYTF	NLVPMVATV
CASSKGGLNEQFF	other
CAISYRGTTQETQYF	NLVPMVATV
CASSVEGAPPDTQYF	NLVPMVATV
CSARPGQGIYEQYF	NLVPMVATV
CASGFGGNEAFF	NLVPMVATV
CASSPTSTLNTEAFF	NLVPMVATV
CASSPQGLASNIQYF	NLVPMVATV
CASSLSPTPYEQYF	NLVPMVATV
CASSPSANTDTQYF	other
CASSLTSGRVDEQFF	NLVPMVATV
CASSPETGIEAFF	NLVPMVATV
CSARRLEQYF	NLVPMVATV
CASSMRSGQPQHF	other
CASSYSVPALGNTIYF	other
CASSPTGQGAYNEQFF	NLVPMVATV
CASSIFIYNEQFF	other
CATQAVNTGELFF	other
CANSSRSGETQYF	other
CASSIWRRGWLHLRF	other
CSVETGGYNEQFF	NLVPMVATV
CASSSPLDWETQYF	other
CASSIVTDTQYF	other
CASSLLSNQPQHF	other
CASSYTLNTEAFF	other
CATSSTPIFSGANVLTF	other
CATGDSTDTQYF	other
CASSREWNTEAFF	other
CASSPGQGAEAFF	NLVPMVATV
CASRDVSGTPGSGEQFF	NLVPMVATV
CASSPWTGTLGETQYF	NLVPMVATV
CASTDRRYGYTF	NLVPMVATV
CASSPDVYGYTF	other
CASSVQGSGTYGYTF	other
CASSQGVLAGPGYKEQYF	other
CASSPRSGEGVWSSYNEQFF	NLVPMVATV
CASSPFGGHGELFF	NLVPMVATV
CASSLSLPAGGRETQYF	NLVPMVATV
CAWSQGTSGGTDTQYF	NLVPMVATV
CASSLWRWGQNIQYF	other
CASSYSGGETQYF	NLVPMVATV
CASSSGPYNEQFF	NLVPMVATV
CASSLERNEQFF	NLVPMVATV
CSVGQALQETQYF	NLVPMVATV
CASSEEGQGRLSEQFF	other
CASSVDGSSYNEQFF	NLVPMVATV
CASSNDRELYEQYF	NLVPMVATV
CASSLWDRGRYEQYF	NLVPMVATV
CASSLQVGMNTEAFF	NLVPMVATV
CSGAPPYNEQFF	NLVPMVATV
CASSPSGGVGTGELFF	other
CASSSPWTSGTYEQYF	other
CASSQSDTNQPQHF	NLVPMVATV
CVSSLYSNQPQHF	other
CASSFGSGAPGELFF	NLVPMVATV
CASSFDGSYNEQFF	NLVPMVATV
CASSLSGGNQETQYF	other
CASSIYFGEKLFF	other
CASTEGHEQYF	NLVPMVATV
CATSDLLEQYF	NLVPMVATV
CASRPSGPQETQYF	other
CASSLPPTSGGLLGTDTQYF	other
CASSMTSYNEQFF	other
CASSDIKDSTDTQYF	other
CASSPSGLAGGHTQYF	other
CASSLLFGNYNSPLHF	NLVPMVATV
CASGGVSGVFF	other
CASSLGGLGQPQHF	other
CASSFKGQSNFYEQYF	NLVPMVATV
CSVPRYRGGDGYTF	other
CASSLGGTEAFF	NLVPMVATV
CSARDGLNEQFF	other
CASSSQRTNFYGYTF	NLVPMVATV
CASSQGRGEQFF	NLVPMVATV
CASKRDNSYEQYF	NLVPMVATV
CASSPTVRTGETDTQYF	other
CAGSIRSSYEQYF	other
CASSLDPVGRNEQFF	NLVPMVATV
CASSKGGGSSYNSPLHF	other
CSASSSELHKSYNEQFF	NLVPMVATV
CASSLRGPNVLTF	NLVPMVATV
CASGLVPTTGELFF	NLVPMVATV
CASGVGSAYEQYF	NLVPMVATV
CASSLYSGGRNTGELFF	other
CASSLGTGSPYEQYF	NLVPMVATV
CASSFYFYNEQFF	NLVPMVATV
CASSPNGGLHEKLFF	NLVPMVATV
CASSSGLAGVVGYEQFF	NLVPMVATV
CASSVEGAGTEAFF	other
CASTPGGLGQPQHF	other
CASSQGTGGFYEQYF	NLVPMVATV
CATSDFLNTGELFF	NLVPMVATV
CASSPGPKETQYF	NLVPMVATV
CATSETETTIYNEQFF	NLVPMVATV
CACSQRSATQEYF	other
CASSYGLNTEAFF	other
CASSPTLLAALTDTQYF	other
CASIRGGGSTDTQYF	other
CSPDRGTAYF	other
CASTSGTGTGELFF	other
CASSIVSRHEQFF	other
CASSLIASHYSEQFF	NLVPMVATV
CASSYGLAGGGEQFF	other
CASSQVTSTGTSETYTQYF	NLVPMVATV
CASSSRSGDTQYF	other
CASSLAARNTEAFF	NLVPMVATV
CATTRGEWSNEQFF	NLVPMVATV
CAIMSTSYTEAFF	other
CSARGGVYNEQFF	other
CVSRSGAEAFF	other
CASSHGGQAGREETQYF	NLVPMVATV
CASSKDRGADTQYF	NLVPMVATV
CASSPVGVGELFF	other
CASKSGAEAFF	other
CAWSEGTGGLAEAFF	NLVPMVATV
CANSPVAGAPHEQYF	NLVPMVATV
CSARQGDTGELFF	NLVPMVATV
CASRAEGRTDTQYF	NLVPMVATV
CATSRDPGSYEQYF	NLVPMVATV
CASSVSRAGTGELFF	NLVPMVATV
CASSLQGLGRNAFF	other
CASSLGGRQGVISYEQYF	NLVPMVATV
CASTRQGLGQPQHF	other
CASSQDLAYEQFF	other
CASSPTGANVLTF	NLVPMVATV
CASSMRWAYEQYF	other
CASSLPIRDRGYATNEKLFF	other
CAITPLGLPYEQYF	NLVPMVATV
CAWSLAGGTEAFF	NLVPMVATV
CASTNSGNTIYF	other
CSARDQYRMNTGELFF	other
CATRKRRGHLNTEAFF	NLVPMVATV
CSVEDDRYQETQYF	NLVPMVATV
CASSIWGQPQHF	NLVPMVATV
CASSGTGDTGELFF	NLVPMVATV
CASSYGGTDGYTF	other
CASSLVANTQYF	NLVPMVATV
CASRNLGGGTNSPLHF	NLVPMVATV
CASSQPPQREQYF	NLVPMVATV
CASSMRSGSEQYF	other
CASSEARSLQETQYF	NLVPMVATV
CATSRDRQVASPLHF	other
CASSSGALITVEQYF	other
CATGLAGGNEQFF	other
CASSSYRGLVSPLHF	NLVPMVATV
CATSDSSGPYNEQFF	other
CASSQERWAEAFF	NLVPMVATV
CSARTGGPLEEQFF	NLVPMVATV
CASSYWDLNYGYTF	NLVPMVATV
CASSTPLTARNGYTF	other
CSALPQGAVNEQFF	NLVPMVATV
CASRELQLVNYGYTF	other
CASSLANGWRGSSYEQYF	other
CASSHGTAGSGNTIYF	other
CASSYSRTGSYEQYF	other
CASGDDNTGELFF	other
CASSQDWRNSPLHF	other
CASSSRPFWDRAMEGANVLTF	other
CATQTSGGFNEQFF	other
CASSMTGGYIAEAFF	NLVPMVATV
CASRDGPSPYF	NLVPMVATV
CASSIRSTVEQFF	other
CSARDLKATLSYEQYF	NLVPMVATV
CASSVATLRVSTNEKLFF	other
CASRPGTSGSDEQFF	NLVPMVATV
CAIGTGHPRTF	other
CASSPVVRAEAFF	NLVPMVATV
CASSLFGYPRAPNTEAFF	other
CASSEAYGTEAFF	other
CASSLASGGNTEAFF	NLVPMVATV
CVRQDRNTGELFF	other
CASSVFSGADTQYF	other
CASSLVQGIEQYF	NLVPMVATV
CASSPQGVSSGNTIYF	NLVPMVATV
CSVEDRANEQYF	other
CASSLALHSDGYTF	other
CASSLAGGRDEQYF	NLVPMVATV
CATILYEILLGKASSMRSTDTQYF	other
CATSRDGTSGANVLTF	NLVPMVATV
CASSDGNTGELFF	other
CASTKGASPGDEQFF	other
CASSDPASGIDYEQYF	NLVPMVATV
CSARAARLAGTDTQYF	NLVPMVATV
CASSSISGSYNEQFF	NLVPMVATV
CASSLSRQPQHF	NLVPMVATV
CASSESGSGRAETGELFF	other
CTSSSVNEQFF	NLVPMVATV
CASGGSSYEQYF	other
CASSESLEGVNEKLFF	NLVPMVATV
CSRPAGDASYEQYF	other
CASSELSGGADTQYF	other
CASSYSNTQNEAFF	other
CASSPGTSGGPFTDTQYF	other
CASSAQDHSDPNTGELFF	other
CASSSRSVGELFF	other
CASQDDYSNQPQHF	NLVPMVATV
CASSWSSYEQYF	NLVPMVATV
CASSLVYGGASDSYNEQFF	NLVPMVATV
CSARNYRGGTGELFF	NLVPMVATV
CASSIVLVPGLAGGISYEQYF	NLVPMVATV
CASKVSLSETQYF	NLVPMVATV
CSVPDVSSYNEQFF	NLVPMVATV
CASSLRQGRLETQYF	NLVPMVATV
CAIQYANTGELFF	other
CASRLFETQYF	NLVPMVATV
CATSFRGVQFF	NLVPMVATV
CASSLVAGPGTDTQYF	NLVPMVATV
CASSYSTSAYEQYF	other
CASSYGQGGEQYF	NLVPMVATV
CASSARSAYEQYF	other
CATSRDRGGGTQETQYF	NLVPMVATV
CASSYSTGYGYTF	other
CSARDTSNQPQHF	other
CASSRTGLNTEAFF	other
CASSPQGSSPLHF	other
CASSSRGLPYEQYF	other
CASTPGTGMSYGYTF	other
CASSTNTGTEAFF	NLVPMVATV
CASSEARDGETQYF	NLVPMVATV
CASSLLTSGGTYEQYF	NLVPMVATV
CSARDREEANYGYTF	NLVPMVATV
CSAPTPTRGGYTF	NLVPMVATV
CASRPGQGDTQYF	NLVPMVATV
CASSFGQGSEKLFF	other
CASSLVDRGADTQYF	other
CASRDRGVNEQYF	NLVPMVATV
CASSPRLVAGSAYNEQFF	other
CASSLVLMETQYF	NLVPMVATV
CASTAGASGTDTQYF	NLVPMVATV
CASSQDGVGGSGTGELFF	NLVPMVATV
CASSLGQGAGGQPQHF	other
CASSTGLNGRAQYF	other
CASSSIDRDINEQFF	NLVPMVATV
CASSPGGYEQYF	NLVPMVATV
CASRATGGVTTEAFF	other
CASSLASGGQETQYF	NLVPMVATV
CASSFSANEQFF	NLVPMVATV
CASTFGAYNSPLHF	NLVPMVATV
CSALPGIYNEQFF	other
CASSQDKRPGGELFF	NLVPMVATV
CSVKVGVYEQYF	other
CASSIDHGGRDGYTF	other
CSAGQENYGYTF	NLVPMVATV
CASSWGLAEFF	other
CSVAGDLGTGELFF	other
CASSPYRGLELEYQPQHF	other
CASSPERNPGWNTEAFF	NLVPMVATV
CASSPSVNPGGYGYTF	other
CSSSLAPGATNEKLFF	NLVPMVATV
CASSFRSQETQYF	other
CASSETGLNTEAFF	other
CASSPYGGNTDTQYF	NLVPMVATV
CSARPIAGGPYEQFF	other
CANSIRSTDTQYF	other
CSVGDGNEKLFF	other
CASSAPSHSTDTQYF	other
CASNGGYSTDTQYF	other
CASSQGTLGNTGELFF	NLVPMVATV
CASSFRGRESYEQYF	other
CASSLSGELFF	NLVPMVATV
CASSIVGGAYNEQFF	NLVPMVATV
CASSPYREPLYEQYF	NLVPMVATV
CASAVGNEQFF	other
CASSQGLYEQYF	NLVPMVATV
CSARDWGEETQYF	NLVPMVATV
CAISESTAERSGANVLTF	other
CASSQTQYF	NLVPMVATV
CASSEGTSVPLAELFF	NLVPMVATV
CASSYRWDGVSYGYTF	other
CASSSSDTSYGYTF	NLVPMVATV
CASSSGLGQPQHF	other
CASSRWGQGTRGYTF	NLVPMVATV
CASSQLSGRVNEQFF	NLVPMVATV
CASRKQGNTGELFF	NLVPMVATV
CSALDRAIANTGELFF	other
CASSLRPADTQYF	other
CASQEANTGELFF	other
CASSWGGDNEQFF	NLVPMVATV
CASSARSSGELFF	other
CASSIGTASYNEQFF	NLVPMVATV
CASGEANTGELFF	other
CASSQDREVFNEQFF	NLVPMVATV
CASSLGQGNTEAFF	NLVPMVATV
CASSPQAGASYEQYF	other
CASSPPYRGSGTEAFF	NLVPMVATV
CASSQQGYTEAFF	NLVPMVATV
CASSSTNSGGTDTQYF	NLVPMVATV
CASSEAGQAYEQYF	other
CASCLRGGAHEQFF	other
CASSLGQVSYNEQFF	other
CASSQYGGGSQETQYF	NLVPMVATV
CASSLPGGYNEQFF	other
CASSVGVAGFNEKLFF	other
CASSYPQAGQGEQYF	NLVPMVATV
CASSINAYNEQFF	other
CASSSGQGGTGELFF	other
CASSLEEGYEQYF	NLVPMVATV
CASSPGTGYEQYF	other
CATSNLNTGELFF	other
CASSSWERADTQYF	other
CASSSGSIETSGGPEQYF	NLVPMVATV
CASSSPDRQREETQYF	NLVPMVATV
CASSGQGDTGELFF	other
CASRTFGGSSYNEQFF	other
CASSDLWPNSYEQYF	NLVPMVATV
CASRGGIEEQYF	other
CASSIRSAIEQYF	other
CSVVDTNTGELFF	NLVPMVATV
CSAEATGGNQPQHF	other
CASSDRIPYGYTF	other
CASSQAMNTEAFF	NLVPMVATV
CASRSFSNQPQHF	other
CASSFMGASTDTQYF	other
CASSVAGGYEQYF	other
CASSPNTGELFF	NLVPMVATV
CASSPGGAGELFF	other
CAISSRSSYEQYF	NLVPMVATV
CASEDFRDAPNTGELFF	other
CASSQDLTFIKTQYF	other
CASGSLTGKDEQFF	other
CASSQGQTNEKLFF	other
CSVDSGGYQETQYF	NLVPMVATV
CASRAGIETQYF	NLVPMVATV
CASSIRSGVIQYF	other
CASSTTGIDGYTF	other
CASSTGQGQEQYF	other
CATSRDLGGGAEDTQYF	NLVPMVATV
CASTPGLAGAGNEQFF	NLVPMVATV
CASSFRDPHQPQHF	other
CASSWGTGNYEQYF	other
CASSLPGAQREAFF	other
CASSYSRDKAEGFSYEQYF	NLVPMVATV
CSARGTEGEQYF	NLVPMVATV
CASSQTQLWGTQYF	NLVPMVATV
CASSTLDRTSGFDTQYF	other
CASVMTGGFTEAFF	other
CASSSVNNNEQFF	other
CASSQEVVNYGYTF	other
CASSKRSQETQYF	other
CASSQRAGGELFF	other
CASSSSGTDLYGYTF	NLVPMVATV
CASSEKAGQGAEEQFF	NLVPMVATV
CASSPFGVGNSPLHF	other
CASSITSGSLNEQYF	other
CASSDGARSDYGYTF	other
CASSLVDGDIQYF	other
CASSPGTVATGELFF	other
CASSLLVAGVYEQYF	NLVPMVATV
CASSPFETAYEQYF	other
CASGTLNSLVAFF	other
CASSSLRTVNNEKLFF	NLVPMVATV
CASSLDTGIYTEAFF	other
CASSTRDTQYF	other
CAFDKSNEKLFF	NLVPMVATV
CASSPQTGLYGYTF	NLVPMVATV
CASSLALSHEQFF	NLVPMVATV
CASSLLQGGEQYF	NLVPMVATV
CASSDGGATDTQYF	other
CASSPGLDYGYTF	other
CASSASGGTDTQYF	NLVPMVATV
CASGDRNGYTF	other
CASSPQGYEQYF	other
CASTISGNEQFF	NLVPMVATV
CASSKAERPGYGRLTESYNSPLHF	NLVPMVATV
CASSLRSAGEQYF	other
CASSLYSRGVTNEQFF	other
CATSDRGTGGSYEQYF	NLVPMVATV
CATSRVSWTDEQYF	NLVPMVATV
CASSPIGGAGELFF	other
CASSVAGGGLNEQFF	NLVPMVATV
CASSIFSAALRPATF	other
CASSLPGLAYNEQFF	NLVPMVATV
CASSSGLAGRTSYYNEQFF	NLVPMVATV
CASSMGSVGYTF	other
CASSQDWAGTDSGANVLTF	other
CATSGDISSYNEQFF	NLVPMVATV
CATSDLNTGRTTNEKLFF	NLVPMVATV
CAWSGDSFEQYF	NLVPMVATV
CASSPGTSGVNEQYF	NLVPMVATV
CASGRGDGPQHF	NLVPMVATV
CASSIGGGSNQPQHF	other
CSVRPPSDRVIRPEAFF	other
CASSILAGGPDEQFF	NLVPMVATV
CASSPTNGRSAGGTRGYTF	NLVPMVATV
CASSVGVETGEQYF	other
CASSPGLAGGYEQFF	other
CASSLNPQQPQHF	NLVPMVATV
CASSLDPGLPLYNEQFF	NLVPMVATV
CSAPFVTGRSGELFF	NLVPMVATV
CSALPLTNPPHGANVLTF	NLVPMVATV
CASSALAGRYNEQFF	other
CSVRTYEKLFF	NLVPMVATV
CSVWVAGENTEAFF	NLVPMVATV
CASSLYGLVEAFF	NLVPMVATV
CASTPGTGVSGEQYF	other
CASSLGTGAPANTGELFF	other
CASSQGSAGNQPQHF	other
CASSPRSADTQYF	other
CASSFGVNTEAFF	other
CASSLWDTGEQYF	NLVPMVATV
CASSYGPWDEQFF	NLVPMVATV
CASSAGTENTEAFF	other
CSARDGGTGVGWVDTQYF	NLVPMVATV
CASSIRGAHEQYF	other
CAISDLKNYGYTF	NLVPMVATV
CASSYGGNEQFF	NLVPMVATV
CASSPSHGLNTGELFF	other
CASQNENTGELFF	other
CSVVVGQGTRWRETQYF	other
CASSAGTGFLFF	NLVPMVATV
CASSLGVGSPAFF	other
CSAEQDGYEQYF	other
CASSYSGGDEQFF	other
CATSRDFLGDKDYEQYF	other
CASSRWDTTYEQYF	NLVPMVATV
CASSLASGNSYEQYF	other
CASSQEGYQPQHF	NLVPMVATV
CSAASLLRLAGEYNEQFF	other
CAVQMGRGYTF	other
CASSIFVGALSDEQYF	other
CSARDPSARAIYGYTF	other
CASSSLGWGVTDTQYF	NLVPMVATV
CASSVEGGNTIYF	other
CASSLIDRENTEAFF	other
CASSLAATYNEQFF	NLVPMVATV
CSARDLRLAEETQYF	NLVPMVATV
CASSDLNTGELFF	other
CASSEADRNTGELFF	NLVPMVATV
CASSQREMYDTGELFF	other
CASSTHHGAEAFF	other
CASSLVPTGQETQYF	other
CASSAQDRGKETQYF	other
CASSQDEGNEQFF	NLVPMVATV
CASSYQNTGELFF	other
CASTRLLGSADTQYF	other
CASSWGGNTQYF	NLVPMVATV
CASSPGSLYYGYTF	NLVPMVATV
CASSVTARGPFLLYNSPLHF	NLVPMVATV
CASSLADRGSYNEQFF	other
CASSEEKYEQYF	other
CATSVGLNTEAFF	NLVPMVATV
CAPMWAPLHF	NLVPMVATV
CASSQGLNTGELFF	other
CASSLWGLAGQDTQYF	NLVPMVATV
CASSLGSTNRNTIYF	NLVPMVATV
CASTQSWQGQETQYF	other
CASNPPPGDSENTGELFF	other
CASSQISNQPQHF	other
CASSLDRGPLNEQFF	NLVPMVATV
CAWSVGSYEQYF	NLVPMVATV
CASSVGLAGGGEQFF	NLVPMVATV
CATEEREKDTQYF	other
CASSLFPGLYGYTF	other
CASSYSNEQYF	NLVPMVATV
CSVEEGQGNGELFF	NLVPMVATV
CSADREAFF	NLVPMVATV
CASSSRDSYEQYF	other
CASSPDIEQYF	other
CASSLKQSGHYQETQYF	other
CSVGSIYGYTF	other
CSASPGQNSFTEAFF	NLVPMVATV
CASSRGLAANTGELFF	other
CASSPGGLEQFF	other
CASSLANWTGLPDTQYF	other
CASSLDRLEQYF	NLVPMVATV
CSAGGNHYEQYF	NLVPMVATV
CASSARDRVVDEQFF	NLVPMVATV
CSVGSSGTNEKLFF	other
CSVESGTDYNEQFF	NLVPMVATV
CSATPWVGLSFSKQPQHF	NLVPMVATV
CASSITSVNGYTF	other
CATSKSYSGDTQYF	other
CASSLGLAGIQETQYF	NLVPMVATV
CASSQGPASGGELFF	other
CASSFAQGTYEQYF	NLVPMVATV
CASSLASNEQFF	other
CASSQFQYFYGYTF	other
CASRGSGEKLFF	other
CASSWGTGSGPQHF	NLVPMVATV
CASSDSYGYTF	other
CASSWGGGAHNEQFF	NLVPMVATV
CASSSPSGGVEDEQFF	NLVPMVATV
CASSGQEPGVLLGEETQYF	NLVPMVATV
CASSSPHRDSYSPLHF	other
CASSPPGQGIDEQFF	other
CSVEDRVAMNTEAFF	NLVPMVATV
CASSFVMGTDTQYF	NLVPMVATV
CSVVKPNTGELFF	NLVPMVATV
CSANWQGGQYF	NLVPMVATV
CANRDRGRDEQFF	other
CASSRDRSSYNEQFF	NLVPMVATV
CASSAYLGAGELFF	other
CASSFRTADTEAFF	NLVPMVATV
CASISSNQPQHF	other
CASSFAAGGRNEQFF	NLVPMVATV
CSVGTLNTGELFF	other
CASSYMGGVGTDTQYF	NLVPMVATV
CACFENYGYTF	NLVPMVATV
CASSHLLDRGQETQYF	NLVPMVATV
CSVLSMGKLFF	NLVPMVATV
CASRGGRGTDTQYF	other
CSARDEGYEQYF	NLVPMVATV
CSVTGPDYLGQYF	NLVPMVATV
CASSQVGTYGYTF	NLVPMVATV
CASTPGTGASPLHF	other
CASSGGGLPLSSGNTIYF	NLVPMVATV
CATSGFPDTQYF	NLVPMVATV
CASSYGGGDEQYF	NLVPMVATV
CASTWTGAYGYTF	other
CASRQNTEAFF	other
CASTSGQGETGELFF	other
CASSFLGKNEKLFF	other
CASRSSAEAFF	other
CASSPSWLSGVTQYF	other
CASSWDREVGLNTEAFF	NLVPMVATV
CSARGLDRIYYNEQFF	NLVPMVATV
CSARASYEQYF	other
CASSDGSGALETQYF	NLVPMVATV
CASSIVHTYGSPLHF	NLVPMVATV
CASSFPSAEQYF	NLVPMVATV
CASSQGAGNSPLHF	NLVPMVATV
CSARDPDRLYGYTF	NLVPMVATV
CAWNPANSGNTIYF	NLVPMVATV
CANGKANTGELFF	other
CASSLISYNEQFF	other
CASSPTRGAEQYF	NLVPMVATV
CASSPDRGRTNEQFF	NLVPMVATV
CASSIVAQYEQYF	other
CASSIRAGDTQYF	other
CASTPGGLTEAFF	NLVPMVATV
CASSQDIEAFF	other
CASAWIGTGELFF	other
CASSQEERGGTDTQYF	NLVPMVATV
CSFKREGPFANTGELFF	NLVPMVATV
CASSIVGGIAYNEQFF	other
CASSPGLIYNEQFF	NLVPMVATV
CASSVHGVSEQYF	other
CASRSLGGVAEAFF	NLVPMVATV
CAWRLGSGEKLFF	other
CASSDIKGEQFF	NLVPMVATV
CASSLSSVWQDLSYEQYF	other
CSARGLAGGPVETQYF	NLVPMVATV
CASSPVSYNEQFF	other
CASSPSTGELFF	other
CATSNRAGNTIYF	other
CASSPIGSTDTQYF	other
CASSSTFEGLADTQYF	NLVPMVATV
CASSPGTGLEKLFF	NLVPMVATV
CASSWELGVAEAFF	other
CASSESEGLGEKLFF	other
CASSVLTSGAGDEQFF	NLVPMVATV
CASSLRAGMNTEAFF	NLVPMVATV
CASSQLDSSLQETQYF	other
CASSLRSDTEAFF	other
CASSLDAVGFYGYTF	NLVPMVATV
CASIPGTGQNTEAFF	NLVPMVATV
CASSLESGTGANYGYTF	other
CAWSQMGLGTEAFF	other
CSAMGWDSSYEQYF	NLVPMVATV
CATSSTGSEDTQYF	NLVPMVATV
CASSPLSASEEFF	other
CATSDPGGDRETGTEAFF	other
CASGDGSYYGYTF	NLVPMVATV
CASSSPREREITDTQYF	NLVPMVATV
CASSQETDKNSPLHF	other
CASSSTYSGGTYEQYF	other
CASSLTKGGDEQFF	NLVPMVATV
CASSFRTGALAGYTF	NLVPMVATV
CAVGRGATEAFF	NLVPMVATV
CSVLKGTEAFF	other
CASSPSGRIHEQFF	NLVPMVATV
CASSLFPEDSYNEQFF	other
CSTLTQGEAFF	other
CASSGTGGSTEAFF	NLVPMVATV
CASSQVLGGGDTQYF	other
CASSQLGGDSSGANVLTF	other
CSASSGALSISYEQYF	NLVPMVATV
CASSMRSGAVTQYF	other
CASSYGEISGQPQHF	other
CASSSIRGAQMNTEAFF	NLVPMVATV
CASSILSRDRPSTDTQYF	other
CSGSGGQVDGYTF	other
CASSPGGELFF	other
CASSFISTDTQYF	other
CASSRSSGANVLTF	NLVPMVATV
CASSGQGSPEAFF	NLVPMVATV
CASSFRDANTEAFF	NLVPMVATV
CSVGRDPNSYEQYF	NLVPMVATV
CASSCGTDPYNEQFF	NLVPMVATV
CASSIFDGSYEQYF	other
CASSTDPAYEQYF	NLVPMVATV
CASRGAQGSVIHIQYF	NLVPMVATV
CSARDPGGRSSYEQYF	NLVPMVATV
CASSHGGDSGNTIYF	other
CASSHRTGDEKLFF	other
CASSQGYGSTEAFF	NLVPMVATV
CASSFYICSARASYEQYF	other
CASSLEHRGVFGYGYTF	other
CASSQRGNEQFF	other
CASSLMGDPQPQHF	NLVPMVATV
CASRAQGAYYGYTF	NLVPMVATV
CASSKYSVNEQFF	other
CSARGELGVDEQFF	other
CASSVFGTSGEETQYF	NLVPMVATV
CASRTGARGYTF	other
CASSFLRDGLYNEQFF	NLVPMVATV
CAWSPRDRFTDTQYF	NLVPMVATV
CASSEVGQGFNGYTF	other
CSAPTGSGELFF	other
CASSPRPGLADNEQFF	NLVPMVATV
CASSFAGTDTQYF	other
CASSMGSHGYTF	other
CASSEGQGADTQYF	NLVPMVATV
CASSYGARGAEAFF	NLVPMVATV
CASSPSTGGNTEAFF	NLVPMVATV
CASSLHHEQYF	other
CSARETGLAGWIDTQYF	other
CASSSGPRGGQPQHF	other
CASSTPPNTEAFF	NLVPMVATV
CASSPQQATNEKLFF	NLVPMVATV
CASSLALLGGSGNFF	NLVPMVATV
CASSQVFQGASGELFF	NLVPMVATV
CASSDLAEETQYF	NLVPMVATV
CASSSDRGGSPLHF	NLVPMVATV
CASSLRGGMIHIQYF	NLVPMVATV
CASLRDMNTGELFF	other
CASSEALLGNQPQHF	other
CASSLDSSSFDEQFF	NLVPMVATV
CASSSLGGKNYGYTF	NLVPMVATV
CASSHGGKDTQYF	NLVPMVATV
CASGLDIHAFF	other
CASSLVGLSYEQYF	other
CASSGDRGTEAFF	NLVPMVATV
CASSQQTGTIGGYTF	NLVPMVATV
CSARKELGADTSPTYNEQFF	NLVPMVATV
CASSAGTPIYNSPLHF	other
CASSIRGSDTQYF	other
CASSGWEAAYGYTF	NLVPMVATV
CASSQDGTGINIQYF	NLVPMVATV
CATSDLLSTAGVVNTEAFF	other
CASSLRTARSYEQYF	NLVPMVATV
CASSFGNNEQFF	NLVPMVATV
CASSPPAGGKAGELFF	other
CSVLRDNNNEQFF	NLVPMVATV
CASSENRGKGTEAFF	other
CASSSSDSPLADTQYF	NLVPMVATV
CATSRFKGTGDETQYF	other
CASSLTGMNTEAFF	NLVPMVATV
CASSLEGWGSSYEQYF	NLVPMVATV
CASSIGGELFF	other
CSARTSGPPDTQYF	NLVPMVATV
CASSLGVLQETQYF	other
CATSRESGTGGPIQYF	NLVPMVATV
CASSADGTAWNEQFF	NLVPMVATV
CAGGDPNTGELFF	other
CAWTVGNTEAFF	other
CASSFGRAGNQPQHF	other
CASSLEVGLRNQPQHF	NLVPMVATV
CASSLSTSGDNEQFF	other
CSVGRNTGELFF	other
CSAQTGRDTEAFF	other
CASSTGVMTGALGNQPQHF	NLVPMVATV
CASSRDSSANEQFF	NLVPMVATV
CASGSDRGLVGEQFF	NLVPMVATV
CSARDGLAQNTGELFF	other
CASSMRASSEQFF	other
CASKMGAEAFF	other
CASSSNIIRGSSYEQYF	other
CASSMSTSRNEAFF	other
CATSRVPSGSYEQYF	NLVPMVATV
CASSQSGQGNEKLFF	other
CSTQRGGTEAFF	NLVPMVATV
CASSYDGTTSPLDTQYF	NLVPMVATV
CASSLGSGGIPEQFF	other
CASSFWTGGTEAFF	NLVPMVATV
CASSSFGFTEAFF	NLVPMVATV
CASRRPDGGEAFF	other
CASSESNTGELFF	other
CASSYVTTSGGHANTGELFF	other
CASSLNPRDIQYF	NLVPMVATV
CASSWTGTSERFF	other
CASSWDRRAPSYNEQFF	other
CSARGEADTEAFF	other
CASAPQGENQPQHF	NLVPMVATV
CASSYSYPGTGFYEQYF	NLVPMVATV
CASSQDGNRYNEQFF	NLVPMVATV
CASSSSLDYDTGELFF	NLVPMVATV
CASSAGGALTGELFF	other
CASSFRDPYYNEQFF	NLVPMVATV
CASSTTSGGANEQYF	other
CASSSKEGNTEAFF	NLVPMVATV
CASSPTGQGETQYF	NLVPMVATV
CASRPSPGVFNEQFF	other
CASTSGGGADTQYF	other
CASSSTAGPPGEQFF	other
CASSTFSNPYNEQFF	other
CASSQRTSGNTDTQYF	NLVPMVATV
CASSPETGIGGQPQHF	other
CASSPVRKARYEQYF	NLVPMVATV
CASGEARNQPQHF	NLVPMVATV
CASCPLWEGGYTF	NLVPMVATV
CASSQEGGILAEQFF	NLVPMVATV
CATSDLHRGDEQFF	NLVPMVATV
CASSSTDRGFVNTEAFF	other
CSASGYSNQPQHF	other
CASSLRDRAPNEQFF	NLVPMVATV
CASSPLGGGNTGELFF	other
CASSADSPPYTGELFF	NLVPMVATV
CASSLGQGDQPQHF	NLVPMVATV
CAISETLLDFSYEQYF	NLVPMVATV
CASSLGLGSAKNIQYF	other
CASSYSSGQWGWNTEAFF	other
CSAAQGAGELFF	NLVPMVATV
CAWSVSVQGYGYTF	other
CASSARAGSGELFF	other
CAWSISDIMNTEAFF	NLVPMVATV
CASSSPWTDSYNEQFF	NLVPMVATV
CASSQTESTDTQYF	other
CATMASGGINEQFF	other
CASSPFWGGEQYF	other
CASSGRAGNEQFF	other
CASSQEDAGAPYNEQFF	other
CSARDGTRDYEQYF	NLVPMVATV
CASSERGAGDTIYF	other
CASSIRSGSEQFF	other
CASSLETGSNEQFF	other
CASSLYSSSYNEQFF	NLVPMVATV
CAISEGVGGLEQYF	NLVPMVATV
CASTTGLAVMEQYF	NLVPMVATV
CASSDSEGHNTGELFF	other
CASSLTGPPGGYTF	other
CASSPLVGPQPQHF	other
CASGQRGAYNEQFF	other
CASSQTGAEQYF	other
CASSFRRPGLAKNIQYF	other
CASSIGYHGYTF	other
CASSPGLGWPQHF	NLVPMVATV
CASNIAGDYGYTF	NLVPMVATV
CSVGVDYPYEQYF	NLVPMVATV
CASSTGTGGIGGNTIYF	NLVPMVATV
CASSQDEYNTGELFF	other
CAGSTRSSYEQYF	other
CASSLRGEFQPQHF	other
CASSAPSGVEQYF	NLVPMVATV
CSGRGSGDNEQFF	NLVPMVATV
CASSLSALAADTQYF	other
CASSIRSSTEAFF	other
CASSYDRPSFNQPQHF	NLVPMVATV
CASTPLGAGPVNEQFF	NLVPMVATV
CATEYTNTGELFF	other
CSATIEGEYYGYTF	NLVPMVATV
CASSESGSGGIYEQYF	NLVPMVATV
CASSLTGTLVDEQYF	other
CATSRENGGGTDTQYF	NLVPMVATV
CASSPTTGPYGYTF	other
CAISEYGTGAFEQFF	NLVPMVATV
CTSSQTQLWETQYF	NLVPMVATV
CASSRTPMNTEAFF	other
CATGFGGAYNEQFF	other
CAYLEANSYEQYF	other
CASSTTWTRWDHNEQFF	other
CASSSRSSGELFF	other
CASNIYSNQPQHF	other
CASRTGGQPQHF	NLVPMVATV
CASSQEASGGPDTQYF	other
CASSPDITQYF	other
CASSIRGGYEQYF	other
CASSFTGSPLHF	NLVPMVATV
CATSSPGTSGTGELFF	other
CASSQGIRLAGDQETQYF	other
CASSSPGQTYEQYF	NLVPMVATV
CAKGTANTGELFF	other
CAWSEAWTRHTIYF	NLVPMVATV
CASSGVGAYTDTQYF	NLVPMVATV
CASWGGVVNTEAFF	other
CSAREGGAYEQYF	NLVPMVATV
CASSLRQGLINEQFF	NLVPMVATV
CATSDRGQGANWDEQFF	other
CASTPTGAEAFF	other
CATSRGKGDNEQFF	NLVPMVATV
CASSYSGATSGRNEQFF	NLVPMVATV
CASSLAGGHNSPLHF	NLVPMVATV
CASSLDGTGALSNQPQHF	other
CSARDLGETFF	NLVPMVATV
CASSLFSISEQFF	other
CAWSVASTGLNYEQYF	other
CAIQPLLAGAYNEQFF	other
CASTDGLAGELFF	NLVPMVATV
CASSLGLTAYNEQFF	NLVPMVATV
CASSLFDRDDSPLHF	NLVPMVATV
CSARDAPSRETQYF	other
CSVEDTSTQYF	NLVPMVATV
CASRALLGSGETQYF	other
CASSPLVSRNTGELFF	other
CASSQDGASLLYEQYF	NLVPMVATV
CASQATNTGELFF	other
CASSWTGTSEQFF	other
CATILYEILLGKATLYAVLVSASSQRSATQEYF	other
CASSVRASTEAFF	other
CASMGLAGPAGTGELFF	other
CANQDSNTGELFF	other
CASSFGESYEQYF	other
CASSKNSGNTGELFF	other
CASSPHQHEQYF	NLVPMVATV
CASREVGWNEQFF	other
CATSVDPGQLYYEQYF	other
CASSVGGVSTDTQYF	NLVPMVATV
CASSQCPPSYEQYF	NLVPMVATV
CASSEGAGNQPQHF	NLVPMVATV
CASSLQASGSSYNEQFF	NLVPMVATV
CASSPQRERYNEQFF	NLVPMVATV
CASSIVSGNEQFF	other
CASSLAGRETQYF	NLVPMVATV
CASSIRPTGELFF	other
CASSATFNDNEKLFF	other
CASSYSAGTLDYGYTF	other
CASGTWGLDEQYF	other
CASSMTSINEQYF	other
CASSTPSGGSGDTQYF	NLVPMVATV
CASSLEREGRGEQFF	other
CASCQVRGTEAFF	other
CARLAGDTDTQYF	NLVPMVATV
CASSPASGGWNEQFF	other
CASSLGDSFTGELFF	other
CAVNLGDNLADEQYF	other
CASSQKVGFSYEQYF	NLVPMVATV
CARERDRNTGELFF	other
CATQDVNTGELFF	other
CASRDRVEEQYF	NLVPMVATV
CAWGIGTGELFF	NLVPMVATV
CASSQDSSGGYNEQFF	NLVPMVATV
CASSVGQALGETQYF	other
CASSSGVYGYTF	other
CASSVDISTDTQYF	NLVPMVATV
CASRAANEQFF	other
CATSREWASGTYEQYF	NLVPMVATV
CATSRGRDNEQFF	NLVPMVATV
CATYIGNTGELFF	other
CASVGSTGGEAFF	other
CASSTRSDYEQYF	other
CASSLAGQTSYEQYF	other
CSARSLFGPDGGSYEQYF	NLVPMVATV
CASSMGGEQYF	other
CASSTRSTNTQYF	other
CAGQNLNTGELFF	other
CASSLGGRAVDEQFF	NLVPMVATV
CASSQVSSSAEQFF	other
CASSIRASDTQYF	other
CASSLRSATEAFF	other
CAISGLTGSPDTQYF	NLVPMVATV
CASSLWWRGGTDTQYF	other
CSARDTREGLNEQFF	NLVPMVATV
CASSLRAGWGYGYTF	other
CASSLELGQQNTEAFF	NLVPMVATV
CASSLTSGGNTDTQYF	NLVPMVATV
CAWSLLAGAYNEQFF	NLVPMVATV
CASSELLSRNIAKNIQYF	other
CASSSRLTGELFF	NLVPMVATV
CASSGRDRAYNEQFF	NLVPMVATV
CSARGLAQQETQYF	NLVPMVATV
CATSRERGVTTGELFF	NLVPMVATV
CASSQASMNTEAFF	other
CASSLSMVILESGALGAFF	other
CASSYLGEWNTEAFF	NLVPMVATV
CASSLVAGGGETQYF	other
CASSDGYTGELFF	NLVPMVATV
CASKLGQGYGYTF	NLVPMVATV
CASSLRPTEAFF	NLVPMVATV
CASSLNWEQYF	NLVPMVATV
CASSQGTGMENTIYF	NLVPMVATV
CASSQGGGAADTQYF	NLVPMVATV
CASSLGGDEQYF	other
CANSLRAGETQYF	other
CASRGDSYNEQFF	NLVPMVATV
CASSLPVGDYTGELFF	NLVPMVATV
CSAGLAGVAISTDTQYF	NLVPMVATV
CASSPWASGVIQETQYF	NLVPMVATV
CASSESLTSGGSTGELFF	NLVPMVATV
CASSSDGTSGLDEQFF	NLVPMVATV
CASSFGLSSFRYQETQYF	other
CASSLPGGKVSGANVLTF	NLVPMVATV
CASSSGDTNTGELFF	NLVPMVATV
CASSFRLAGVSDTQYF	other
CASSSWDRASGANVLTF	NLVPMVATV
CSARGGARDMNTEAFF	other
CASSQGERFGNEQFF	other
CASSRRSADEQFF	other
CSARIGVGNTIYF	NLVPMVATV
CAISESWTDYYGYTF	NLVPMVATV
CASRWTGFSGQFF	NLVPMVATV
CASSSTGGDGYTF	other
CASSYGQRVSGYTF	other
CASSARTLRPGSSYNEQFF	other
CASSEGTSGEQYF	other
CASSIRSSWEAFF	other
CASSLHPTYQPQHF	other
CASSKLGGPDEQFF	other
CASSYELQTGVFDTQYF	NLVPMVATV
CASSYGRDRVFF	other
CASSSGTGLDF	NLVPMVATV
CASSYFLAGHTGELFF	NLVPMVATV
CTSSQRGGYNEQFF	other
CSARDGLAMNTGELFF	other
CASSQEGQARGYTF	other
CSAREEAGGPLTGELFF	NLVPMVATV
CASSEPGQGYEQYF	NLVPMVATV
CASSSSPDEQQYF	NLVPMVATV
CASSRRGSDEQFF	other
CASGDGGAPNSYNEQFF	NLVPMVATV
CASSPTAGGNTGELFF	other
CASTVSTGAYEQYF	other
CAISRDSIQFGNTIYF	other
CASSYMGPNTDTQYF	NLVPMVATV
CASSRGRLATGEQYF	NLVPMVATV
CASSHAREQYF	other
CASSPSYSGGEETQYF	other
CASSVDWNAYEQYF	NLVPMVATV
CSARVEFGTSGQLSSYNEQFF	NLVPMVATV
CASAWTVNTEAFF	other
CASSVFGGQPQHF	other
CSVVGTINEQFF	NLVPMVATV
CASSFEGNEQFF	NLVPMVATV
CASSDRGGLYEQYF	NLVPMVATV
CASRSGAKAFF	other
CASSSWDKNTEVFF	other
CAMGPGQVYSGNTIYF	NLVPMVATV
CASSEWLAGRDEQFF	NLVPMVATV
CASSSLRGEGLSYEQYF	NLVPMVATV
CASSQVDSFTDTQYF	NLVPMVATV
CASSDWRTSPWNEQFF	other
CASSSRDEAFF	other
CASSFGIYGYTF	other
CASSPDGNEQFF	other
CASSFYFTGALYNEQFF	NLVPMVATV
CASSIRGSTEAFF	other
CANSQRASYEQYF	other
CASRDHRVPSDTQYF	NLVPMVATV
CASSLGQFQETQYF	other
CASSLRVNLAGGHETQYF	NLVPMVATV
CASSLDRASLDEQYF	NLVPMVATV
CASSEGNRGETQYF	NLVPMVATV
CAGQRANTGELFF	other
CASSLATGMTEAFF	NLVPMVATV
CASSPGGDTSYEQYF	NLVPMVATV
CASSDPPSGGNTDTQYF	NLVPMVATV
CAIPGRGTANQPQHF	other
CASSLGGLGNTIYF	other
CASSSGVYYGYTF	other
CASSYLGQSFHYGYTF	NLVPMVATV
CASSRQGDEKLFF	other
CASSLEGQGPLYYGYTF	NLVPMVATV
CASKQGNPNTEAFF	other
CASSPQGLGTEAFF	other
CASSLGPTGELFF	other
CASSYLGTGTGNTIYF	NLVPMVATV
CATSEGARTSGRYNEQFF	NLVPMVATV
CAILPVFRNNEQFF	NLVPMVATV
CASSLVGEWEQFF	other
CSARPWNSYNEQFF	NLVPMVATV
CATSLTSGGRNEQFF	NLVPMVATV
CASNRREHDEQFF	other
CASSLGVLGQPQHF	other
CAWSVLAGGNTGELFF	other
CASSLDVEQYF	other
CASSLTSGGPDTQYF	NLVPMVATV
CATSPLFSYSDEQYF	NLVPMVATV
CASSFYGTDQETQYF	NLVPMVATV
CASSETGYGYTF	NLVPMVATV
CASSVRDWGSPLHF	NLVPMVATV
CASTLAGGTDTQYF	NLVPMVATV
CASSETENHYEQFF	other
CASSLAQGQPQHF	other
CASSTRELGLAGVIPQETQYF	NLVPMVATV
CASSLGQPQHF	other
CASNYYNEQFF	other
CASSIFGANVLTF	other
CASSETGVGGYTF	other
CASSLGSFYEQYF	NLVPMVATV
CASSLDIEAFF	other
CASSQDGHGSSYNEQFF	other
CASSLRVVGTVYNEQFF	NLVPMVATV
CASSGGIGYGYTF	other
CASSFFSGMISDTQYF	other
CASSLGGQKNTEAFF	NLVPMVATV
CSLGVRSSYEQYF	other
CASSLAGGGNTGELFF	NLVPMVATV
CASSPSGVSASEQYF	other
CASAGTAKAGELFF	other
CSARVADSHYEQYF	NLVPMVATV
CSALTWGLAGYEQYF	NLVPMVATV
CATSRARAPYNEQFF	other
CASSEDHTGFYEQYF	NLVPMVATV
CASSHEGAGANVLTF	NLVPMVATV
CASSYSIVPQGAETQYF	NLVPMVATV
CASSLGSMNTEAFF	other
CASSLDTGTGLEEQYF	NLVPMVATV
CASSYLSTDTQYF	other
CSVDEGLAGGEQFF	NLVPMVATV
CASSPVAGTPHEQYF	NLVPMVATV
CSVERTSIYNEQFF	NLVPMVATV
CASSMFGVAGYTF	other
CASSLTTGLEKLFF	NLVPMVATV
CASSQVQGTYEQYF	other
CASSPGRGNYGYTF	NLVPMVATV
CASSQWSSTGELFF	NLVPMVATV
CASKSTANYGYTF	other
CASSFGSGNTIYF	other
CASSFVGGIDGYTF	NLVPMVATV
CASSRTVQETQYF	other
CASSLVPGINSYEQYF	NLVPMVATV
CATSDRQSRSGELFF	other
CSVGPPEAFF	NLVPMVATV
CTARRLASGSRDEQFF	NLVPMVATV
CASSEGGGPYNEQFF	other
CASSLAQGLTYEQYF	NLVPMVATV
CASSLEARSNKETQYF	NLVPMVATV
CSVVGTSGGANEQFF	NLVPMVATV
CAISQTQLWETQYF	NLVPMVATV
CSVRRQGNVWNEQFF	NLVPMVATV
CASSPGTGFYSEAFF	NLVPMVATV
CSAKGRAKNIQYF	NLVPMVATV
CSARGTLGGYNEQFF	NLVPMVATV
CASSQPDSNQPQHF	other
CASSPTGGWADTQYF	NLVPMVATV
CSAVGTSGGSRPTDTQYF	other
CASSGNEPPQYGETQYF	other
CASFSGTSYTGELFF	NLVPMVATV
CSVGQTYEQYF	NLVPMVATV
CASSIRAAEPQHF	other
CASSHLQGGQYNEQFF	other
CASSLAAGGPNTEAFF	other
CASSQEKGPGNQPQHF	NLVPMVATV
CASSLAGAYNEQFF	NLVPMVATV
CASSLVSASTDTQYF	other
CATSRGRDYSNQPQHF	NLVPMVATV
CASSRTQLWETQYF	NLVPMVATV
CATSRESGGYNEQFF	other
CASSLLSNTEAFF	NLVPMVATV
CASSTYTDTQYF	NLVPMVATV
CASSGSGNTIYF	NLVPMVATV
CASSPPGMVNEKLFF	other
CASGTEAFF	other
CSVPPLGGIGETQYF	other
CASSMRAAAEAFF	other
CASSLRSNTEAFF	other
CASSKEAGASGYAPETQYF	NLVPMVATV
CASSQDSSPNQPQHF	other
CASSARDSRYNEQFF	NLVPMVATV
CASSLADGDQPQHF	other
CASSLGTGRWVDNEQFF	other
CASSLGASGDETQYF	NLVPMVATV
CASSYSMGDGNSPLHF	other
CASSPAALEETQYF	other
CSAREGQDKSYNSPLHF	NLVPMVATV
CASSPDMNTGELFF	other
CASSLDIPSYNEQFF	NLVPMVATV
CASSPTGNTEAFF	NLVPMVATV
CASSLGRQYEQFF	other
CASSEVSSGDNEQFF	other
CASSLGQYNEQFF	other
CASSLGLAGVNGELFF	NLVPMVATV
CASSHRDSDLYGYTF	NLVPMVATV
CASSLGTLQGTVYF	other
CASSFQGLSREAFF	other
CASSDSSGSTDTQYF	other
CASSQGDRDTGELFF	NLVPMVATV
CASSHEGSGGFTF	NLVPMVATV
CSAMGYEGTADLTDTQYF	NLVPMVATV
CASTRNRGLNTEAFF	NLVPMVATV
CASTPLREENNEQFF	other
CASSLGSGSHPAEQYF	NLVPMVATV
CASSPGMEQYF	other
CASSYQTGELFF	NLVPMVATV
CASSIISLDTQYF	other
CASSYSGPAAGQETQYF	other
CASTPEYGYTF	other
CATHSGNTGELFF	other
CASSDRATGELFF	other
CASSLGEKLFF	other
CASSSLTGTGDGYTF	other
CASSIFMSSGNTIYF	other
CASSFRGTYNEQFF	other
CASRKGVTTEAFF	NLVPMVATV
CASSPRLAGGPDTQYF	other
CASSQGDSSYEQYF	NLVPMVATV
CATSREGETYEQYF	NLVPMVATV
CASGRGLAGEFYNEQFF	NLVPMVATV
CASSSTGTGAWDTQYF	other
CASSGSGGLDGYTF	NLVPMVATV
CASSPGTASTDTQYF	NLVPMVATV
CASSFLGAGVADTQYF	NLVPMVATV
CASSFEGGGSLGEQYF	NLVPMVATV
CASSFSGNARGELFF	other
CASSLQGTQYF	other
CASSFSGGNNEQFF	other
CSVEGVRKTNTGELFF	NLVPMVATV
CSARDKRTGELFF	NLVPMVATV
CATLNTDGVRETQYF	NLVPMVATV
CASSMFLGQPQHF	other
CASSIVAGGLNEQFF	other
CASSFTLNTEAFF	other
CASSLGDEYNEQFF	NLVPMVATV
CSARGLAGSNTGELFF	other
CASSHRGTSGSTDTQYF	NLVPMVATV
CASGPGGVGQPQHF	other
CSATPGGSGYTF	NLVPMVATV
CSAPQRQANTGELFF	other
CASSSFPGTGLSGNTIYF	NLVPMVATV
CASSYNRAYEQYF	NLVPMVATV
CASSMEGVPLHF	NLVPMVATV
CSARLDLAFGQYF	NLVPMVATV
CSVPGISYYEQYF	NLVPMVATV
CAVGDRGYEQYF	other
CASSLVHKNNEQFF	NLVPMVATV
CASRPPQGVNEQYF	NLVPMVATV
CASGDLNEQFF	NLVPMVATV
CASSLWGQGWHEQFF	NLVPMVATV
CASSMRATGELFF	other
CSARVEHGLAGSYNEQFF	NLVPMVATV
CASSLGGAGDYNEQFF	NLVPMVATV
CASSLAPRRDRNYEQYF	NLVPMVATV
CASSLGQDTDTQYF	other
CATSTPNTEAFF	other
CASSIFGGAGSYNEQFF	other
CSVVRDREPSNEQFF	other
CASSADIQQYF	other
CASRRFGTEAFF	NLVPMVATV
CATSTWDRGSGANVLTF	NLVPMVATV
CASSFTGPGELFF	other
CASSSGTGGGDTQYF	NLVPMVATV
CSARGLGGETQYF	other
CASSPRGLYEQYF	NLVPMVATV
CASYPWTGEKETQYF	other
CASSWVGYEQYF	other
CATTDLNTGELFF	other
CASSMRSGSGQYF	other
CASSPTATGELFF	other
CASSFYFTGAPYNEQFF	NLVPMVATV
CASSLVGSSYEQYF	other
CASSLIAGGPYNEQFF	NLVPMVATV
CASSEGQLKEF	NLVPMVATV
CASGQGQETQYF	other
CASSLTGLTPLSTDTQYF	other
CASSDSGTDTQYF	other
CSAERTGGGTNEKLFF	NLVPMVATV
CARPPETQYF	other
CSARDFRGPSYEQYF	NLVPMVATV
CSARVVSGGAPYEQYF	NLVPMVATV
CASSLWSAGVHNEQFF	other
CASSKQQRSDYGYTF	NLVPMVATV
CASSQDLLTGEQYF	NLVPMVATV
CASSPIGGMGTGELFF	NLVPMVATV
CASSLGGAGGADTQYF	other
CASSLAVGVVAEQFF	other
CSVSRDSLLLEGEQYF	NLVPMVATV
CASSNTGTGYNEQFF	NLVPMVATV
CASSEAWNTEAFF	other
CASSESGTANEQFF	NLVPMVATV
CASGYSTDTQYF	other
CASSRTLTGLDNEQFF	NLVPMVATV
CASSHGGAYEQYF	NLVPMVATV
CASRPNEGPYEQYF	other
CSAPVGVTAGYTF	NLVPMVATV
CASSFGDQQYF	other
CASSFLAGEGTDTQYF	other
CASSQAPGTGDGYTF	NLVPMVATV
CASSIGSTDTQYF	other
CASSIQLGDEKLFF	NLVPMVATV
CASSPGQGASETQYF	NLVPMVATV
CASSPSGNEQFF	other
CASSARGSGEQYF	other
CATLVDLNTGELFF	other
CASSEPIVTLGFCEQYF	NLVPMVATV
CSARSLDTQYF	NLVPMVATV
CASTEEGSPLHF	NLVPMVATV
CASSTYSGTEAFF	NLVPMVATV
CASSQVWAGGLGDTQYF	other
CASSLGTSGGFTDTQYF	other
CATSRVQQENEKLFF	NLVPMVATV
CASSQGLAGVHEQFF	other
CASSQVGLRIYNEQFF	NLVPMVATV
CASSIVSSETQYF	other
CASSQAAGPYNEQFF	NLVPMVATV
CASSPWTAGRTGELFF	other
CASSSSLASTDTQYF	NLVPMVATV
CASSPEEGGWSYEQYF	other
CSVAQYGTSGLNEQFF	NLVPMVATV
CANSSVNEQFF	NLVPMVATV
CATSRDRAYF	NLVPMVATV
CASSQEGGLAWETQYF	other
CASSLMLFGGYPMNTEAFF	NLVPMVATV
CASSQDGDRVYGYTF	other
CASSLSGTSGNNEQFF	NLVPMVATV
CSARAGEGVYEQYF	other
CASRGQGFSYEQYF	NLVPMVATV
CASSFGGDTQYF	other
CASSLEPLSGNTIYF	other
CAIRDRDRNYEQYF	NLVPMVATV
CASSLRQDYGYTF	other
CASSLYYLTNSYNEQFF	other
CASSPVLAGGEDTQYF	other
CASSSFGSSGGMDTQYF	other
CASTDMNTGELFF	other
CASGSGAEAFF	other
CSARDGLAGGYEQYF	NLVPMVATV
CASSDRTGGGETQYF	other
CSVTTGAGGYEQYF	NLVPMVATV
CASSLYITEPQHF	other
CASSKLSTDTQYF	other
CASSQVLAGEGTDTQYF	other
CASSSESYNEQFF	NLVPMVATV
CASSNRAAYEQYF	other
CASSWDSQSSGNSIYF	other
CASSSTGGPKNEQFF	other
CASSYSFTEATYEQYF	other
CSASTGLYPYEQYF	other
CASSYSSNPGELNSPLHF	NLVPMVATV
CASSFGQLAEAFF	NLVPMVATV
CASSLGVSYNSPLHF	NLVPMVATV
CASINEGLGQPQHF	other
CASSPQGYNSPLHF	NLVPMVATV
CASISSGGASYNEQFF	other
CASRPGTVNTEAFF	NLVPMVATV
CASSYYGSYNSPLHF	other
CASSVQSSYEQYF	other
CASSPPGEGSTDTQYF	NLVPMVATV
CASSLLGHSNQPQHF	other
CSASQLGLGQPQHF	other
CSVEGSLGRALRANEQFF	other
CASSLGGETQYF	other
CASSVDSLGNTIYF	other
CASGVGQGYEQYF	other
CASSTNPDRSNIQYF	NLVPMVATV
CASTTGMGQPQHF	other
CAAQMTNTGELFF	other
CASSLRGSSYEQYF	NLVPMVATV
CASSYLTGSTEAFF	NLVPMVATV
CASSTPGRSFEAFF	NLVPMVATV
CSAHPEEGEQYF	other
CASSQPSGAVNNEQFF	other
CASSYGGYEQYF	NLVPMVATV
CASSVYDSTGELFF	other
CASSIDGGLYNEQFF	NLVPMVATV
CASSYNLAGTSLDEQFF	other
CASSEARNQPQHF	NLVPMVATV
CASSVGALSQETQYF	NLVPMVATV
CASSQEFQGWGEKLFF	other
CASSKNYEQYF	other
CASIRGQGVDTEAFF	other
CASSEPQEGPEAFF	NLVPMVATV
CASLRGAEAFF	NLVPMVATV
CSVQTTRNTQYF	NLVPMVATV
CASSGSKGAAGELFF	other
CASSLAIGQGNYEQYF	NLVPMVATV
CASSTRATSEQYF	other
CSARPFGTSGPSSYNEQFF	NLVPMVATV
CASSLDLGVGGQPQHF	other
CASSPSMSTEAFF	NLVPMVATV
CATIPSVGQETGELFF	NLVPMVATV
CAGLGGRDRETQCF	NLVPMVATV
CASSLALAGTDTQYF	other
CASSPQGPGTGELFF	other
CATGQGYSPLHF	other
CASSLFQGDEQFF	other
CASSPIAGRRDTQYF	NLVPMVATV
CSAEDRDTGELFF	NLVPMVATV
CSAPTSGGWFF	other
CASSPGQAYEQYF	other
CASSSVFVTYSNQPQHF	other
CASSRQGDEQYF	NLVPMVATV
CASSPSGFTDTQYF	NLVPMVATV
CASNLKGLAGGPGTQYF	NLVPMVATV
CTNPGDPCYNEQFF	NLVPMVATV
CSARASTSGDSNEQFF	NLVPMVATV
CASSLPGLAENQETQYF	other
CASSFFVGAGVGETQYF	NLVPMVATV
CASSFNGNSPLHF	other
CASSEGTASYGYTF	NLVPMVATV
CASSFAGTEAFF	other
CASSLDSTSGGGYNEQFF	NLVPMVATV
CASSLGDDNSPLHF	NLVPMVATV
CASSHPRRGGEEKLFF	other
CASIHGPSRDTGELFF	NLVPMVATV
CASSRNWVDTEAFF	other
CASSTWGGGAYNEQFF	other
CASSQTQLWETRYF	NLVPMVATV
CASSRFALNTEAFF	other
CASTNRQEGQETQYF	other
CASSEHRTGSDYGYTF	other
CSARDGVTSGIYNEQFF	NLVPMVATV
CASSFATKQYF	other
CASSPLDNWEQFF	other
CASSYIAGAYNEQFF	NLVPMVATV
CASSSFLTYEQYF	NLVPMVATV
CASSSTTGDGYTF	NLVPMVATV
CASSPLDNWEQFF	other
CANTGAGDRVIYNEQFF	other
CASSDSPRVDEQYF	other
CASSYRGLDNEQFF	NLVPMVATV
CSARALAGDTYNEQLF	NLVPMVATV
CASSHPGQGITNEKLFF	other
CASSLVGGRNGYTF	NLVPMVATV
CATGKTSGLTGAGELFF	NLVPMVATV
CASSFSGNTEAFF	NLVPMVATV
CASSNPGTSTEDTQYF	other
CASSLGGAEAFF	other
CASSDPLAGGNEQYF	other
CSARPRDRENNEQFF	NLVPMVATV
CATSKDPSTGSDEQYF	NLVPMVATV
CAGGVNPNTGELFF	other
CASSIGTGNEQFF	NLVPMVATV
CSARARDYSASQETQYF	NLVPMVATV
CASSQDATSGLSYNEQFF	NLVPMVATV
CASSLFQGPSGNSGNTIYF	NLVPMVATV
CASSFQNTGELFF	other
CASSSGTGGVGELFF	NLVPMVATV
CSATTGTGGYEQYF	NLVPMVATV
CASSIYSSYEQYF	other
CASRNRDTVRTEAFF	NLVPMVATV
CPSSRTGLNTEAFF	other
CASSLVGQGAANYGYTF	other
CASSLGQSETQYF	other
CASRQIGTSTDTQYF	other
CASSLDRDDNEQFF	other
CSVKDGYYEQYF	NLVPMVATV
CSGLALGGEEQYF	NLVPMVATV
CSDAGPLGTDTQYF	NLVPMVATV
CASSSDRGLTYNQPQHF	NLVPMVATV
CASSRGQSFSYEQYF	NLVPMVATV
CASSQEVGATSGNTIYF	other
CASTIGETGAQHYNEQFF	other
CASRRDSHNEQFF	NLVPMVATV
CASSAGEVAPGELFF	other
CATGGSPLHF	other
CASSLDIETYF	other
CASSYVARVRTNEKLFF	NLVPMVATV
CASSILAGVGRNEQFF	other
CASSWTGQDSPLHF	other
CASSRVIDAHTDTQYF	NLVPMVATV
CASSLTDSQETQYF	other
CATLRDERKGCEQYF	other
CASSQGTFPAGYTF	NLVPMVATV
CASSQGAGQPQHF	NLVPMVATV
CASSQIAGGPYEQYF	NLVPMVATV
CASSQVGVHEQYF	NLVPMVATV
CASPPRDEQYF	other
CASSFRLAGGTDTQYF	NLVPMVATV
CSVGGSYEQYF	NLVPMVATV
CASSQISGLAEETQYF	NLVPMVATV
CASSEAVDRGNTEAFF	other
CASSFDPDRGLEGYTF	NLVPMVATV
CATSDLDSGELFF	other
CASSYFRGYEQYF	NLVPMVATV
CASSLGQGDAFF	other
CASSQVGHYGYTF	NLVPMVATV
CASSIFGGEQLFF	other
CSVEWVHGQYF	NLVPMVATV
CAEGQGFVGQPQHF	other
CASSSDTGYEQYF	other
CASSLGEFTGTDTQYF	NLVPMVATV
CASSAGGTRYNEQFF	other
CSARRLADTYEQYF	NLVPMVATV
CASSPRTSGRANEQFF	NLVPMVATV
CASSQGSMGEQYF	other
CSGTPGQGVGTETQYF	NLVPMVATV
CASSLRVGFDYGYTF	NLVPMVATV
CASSAMDRDEQYF	NLVPMVATV
CSARDDQAVNTGELFF	other
CSARRLAGGSYNEQFF	NLVPMVATV
CASRRRGGNSPLHF	other
CSARPGGGSQSYEQYF	other
CASSKTIGNTEAFF	other
CASSLRTSGGHVQETQYF	other
CAWSVGAGMKYGYTF	other
CASSLGRDSPGELFF	other
CASSPGPTGDNSPLHF	other
CSARDLAGWNSPLHF	NLVPMVATV
CASRSGTGGYEQYF	NLVPMVATV
CSVVTGTGLETQYF	other
CASSIRANTEAFF	other
CASGGTNTGELFF	other
CASSPGTGDADEQYF	NLVPMVATV
CASSSIPRPEAFF	NLVPMVATV
CASRYSGGDTGELFF	other
CASSRTSGGLNEQFF	other
CATMPDRNTGELFF	other
CSVTFGTGGTEAFF	NLVPMVATV
CASNERWEGTYGYTF	other
CASSNEGGGRGGYTF	NLVPMVATV
CASSIYGQSEQYF	other
CASSIYSISEAFF	other
CASSWTGNEQFF	other
CSATKSGTGELGGYTF	other
CASSLSGGEYGYTF	other
CARGDQNTGELFF	other
CASSLGPSTYNEQFF	NLVPMVATV
CASSPVRGSTDTQYF	NLVPMVATV
CASSLAGGGTGELFF	NLVPMVATV
CASSQGGVRQGAADTQYF	NLVPMVATV
CASPQGGCYEQYF	other
CASSLRDRGARPNTEAFF	other
CAISESPDMLMGNEQFF	NLVPMVATV
CASSPPGSSDNSPLHF	NLVPMVATV
CASSQDSQGLNYEQYF	other
CSVELLYNEQFF	NLVPMVATV
CASSMFDLPYNEQFF	other
CASSSQNTGELFF	other
CASRGFSDQPQHF	other
CATGQTYEQYF	other
CASKDALGETQYF	NLVPMVATV
CASSLKSSTFTDTQYF	NLVPMVATV
CASSLARGTGSYEQYF	NLVPMVATV
CASSLERLAGPDGSYEQYF	other
CAISESGRANTEAFF	other
CASSLAWGRDYTEAFF	other
CASSEGGTGYTDTQYF	NLVPMVATV
CASSIVHVSYNEQFF	other
CASSLAPTGGPYNEQFF	NLVPMVATV
CASSSHMNTEAFF	NLVPMVATV
CASSLFDLRGGTEAFF	NLVPMVATV
CASSDWGTEAFF	other
CASSPVGTGELFF	other
CSVNIAYNEQFF	NLVPMVATV
CSAGQGVGQPQHF	other
CASSEGPARVDTQYF	NLVPMVATV
CASSPWTSGMDTGELFF	NLVPMVATV
CSVLGTEKNTGELFF	NLVPMVATV
CAIAGQGNTGELFF	other
CSARKSASVRETQYF	other
CASSSSRSSYEQYF	NLVPMVATV
CASSERVSGLNEQYF	NLVPMVATV
CASSLEGRGYYEQYF	NLVPMVATV
CASSLNPGEQYF	NLVPMVATV
CASSPPLGGELFF	NLVPMVATV
CASSQAEMAEQFF	NLVPMVATV
CASTPGKREAPPYNEQFF	other
CASRIHGGAINEQFF	other
CASSGGTELAKNIQYF	other
CASSYSLRYTEAFF	NLVPMVATV
CSVRQSSIYGYTF	other
CASSPGTGYYEQYF	other
CASSARTPRPGSSYNEQFF	other
CAWSVWRRESGANVLTF	NLVPMVATV
CASSQDRGTSTDTQYF	other
CASSQARMAEQFF	NLVPMVATV
CATSRDWASGRSGELFF	NLVPMVATV
CASSLSGLGEQFF	other
CASSLGGGVSEAFF	other
CASSYTWDEQYF	NLVPMVATV
CASQQANTGELFF	other
CSVEDLSGRELNNEQFF	NLVPMVATV
CASSLEGLVAVETQYF	other
CSARNYQGANTEAFF	NLVPMVATV
CASSPTGGPGDTQYF	other
CASSIYGLAGANNEQFF	NLVPMVATV
CASSLFASGNEQFF	other
CASSPEAQGAGHNEQFF	NLVPMVATV
CSARGAGTPGDPQHF	NLVPMVATV
CAISDSGQMNTEAFF	other
CASSYILAGGPPSDTGELFF	NLVPMVATV
CAISEPDRGLGYTF	other
CANSLAPGATNEKLFF	NLVPMVATV
CASSGTVPTFNSPLHF	NLVPMVATV
CASGTGGLAVYEQYF	other
CASSSGQGESWTYNEQFF	NLVPMVATV
CASSPWTGDEQYF	NLVPMVATV
CASREETQYF	NLVPMVATV
CASSDFREETQYF	NLVPMVATV
CASSIYSSSYNEQFF	other
CSVERSGVQTDTQYF	other
CASSAMTGWGGYTF	other
CASSFTPYNEQFF	other
CASEGGGSTEAFF	other
CASSEGLSGLRGNGFF	NLVPMVATV
CASSLTGQGRNEQFF	NLVPMVATV
CAIGLAAADTQYF	NLVPMVATV
CSVDGQGNFNYGYTF	NLVPMVATV
CASSFPTGGLWPSDGQYF	other
CASSQELGNTEAFF	other
CASSYSLDSHSNQPQHF	other
CASSLQGKETQYF	other
CASSQGLAGDTDTQYF	NLVPMVATV
CASSFDGPAGAGETQYF	NLVPMVATV
CASSPLGDADTQYF	other
CASSLGLYGEQYF	other
CASSTSNEQFF	NLVPMVATV
CASSQWTGGGGQPQHF	other
CASTPVAGVNRNEQFF	other
CATILYEILLGKATLYAYEQYF	other
CSARESGAGDTGELFF	other
CASSTRDRGSEQFF	other
CSARDNLAGDTDTQYF	other
CASNHRDRGRGADEQYF	NLVPMVATV
CASSLGKTSETEETQYF	other
CASSLTRAGGGYTF	NLVPMVATV
CSARDSRAQNTGELFF	other
CASTKGFSGGASLYEQYF	NLVPMVATV
CASSLVVGSGKYEQYF	NLVPMVATV
CSVDQGANSYEQYF	NLVPMVATV
CATSGTGGSGANVLTF	other
CASSDGTGYGYTF	NLVPMVATV
CASSLVDLLAGDSNEQFF	NLVPMVATV
CANQDRTSGELFF	other
CASSEEWLQGNSYEQYF	NLVPMVATV
CASSQPLTGWNTGELFF	other
CSVVDAAPGGSYEQYF	other
CASSPPQDNREETQYF	NLVPMVATV
CSVEDRSYFAGYTF	other
CASSPRAAGELFF	other
CSARPRALSGATGELFF	other
CASSLRGPPSPFLSSYNSPLHF	other
CASNSQNTGELFF	other
CATSRPLLVGGRYTQYF	NLVPMVATV
CASSQVRGTEAFF	other
CASLPRGGPGANVLTF	NLVPMVATV
CASSQFGRNYEQYF	other
CASSLAPWGNEKLFF	other
CASSYGQGLPLHF	other
CACSGRSGETQYF	other
CASSVDLDSSYNEQFF	other
CASSYSWDVVNYGYTF	NLVPMVATV
CASSLDRLRETQYF	other
CASERANTGELFF	other
CASNGLTNTEAFF	NLVPMVATV
CASSARSKNIQYF	NLVPMVATV
CASSPPGVREQFF	other
CASSLGTVYYEQYF	NLVPMVATV
CASKTLGSTEAFF	NLVPMVATV
CASSPSSGGASTDTQYF	other
CASHDRGNQPQHF	NLVPMVATV
CSARDLASSYNEQFF	NLVPMVATV
CASSFVGSAYEQYF	NLVPMVATV
CASSVDEQGPYNEQFF	NLVPMVATV
CASSFGQGADTQYF	other
CAWNLNTEAFF	NLVPMVATV
CASSDGTSNEQYF	other
CSARDIMNTGELFF	NLVPMVATV
CSARGTSGMGYEQYF	NLVPMVATV
CASSPNLAGVKNIQYF	NLVPMVATV
CASRSDAEAFF	other
CASSVRVTGELFF	NLVPMVATV
CSAPQTGLGQPQHF	other
CASSDGAGKNANIQYF	other
CASSDGQTEKLFF	other
CASSQYDTFISPLHF	NLVPMVATV
CASSKGGTRGNEQFF	other
CSAPDHRESADTQYF	NLVPMVATV
CASSWGGGEQYF	other
CAWSGANTDTQYF	NLVPMVATV
CASSNEFATNEKLFF	NLVPMVATV
CASSVDGMNQPQHF	NLVPMVATV
CASSQVQDTNTGELFF	NLVPMVATV
CASSPATGNTEAFF	NLVPMVATV
CASSQDYFSAKNIQYF	NLVPMVATV
CASSPASRTGARGYTF	NLVPMVATV
CASSFLGKSYEQYF	NLVPMVATV
CSARGDISTEAFF	NLVPMVATV
CSGWADSYNEQFF	other
CASSGRSAVEAFF	other
CASSLGWNQPQHF	other
CASSPLNGGNTGELFF	other
CASSLGSGGEQYF	NLVPMVATV
CATSIDIEQFF	NLVPMVATV
CASTPSSGIGYNEQFF	NLVPMVATV
CSARGRTSAEREQYF	NLVPMVATV
CASSLGQGAHNEQFF	NLVPMVATV
CSVEAGGNQPQHF	other
CSARDEVAHNTGELFF	other
CASSILDVSWTGSNQPQLF	NLVPMVATV
CASSSVTGTPLEAFF	NLVPMVATV
CASSYRPIFWEQYF	NLVPMVATV
CASSPPTFSYEQYF	other
CSATLGNQPQHF	NLVPMVATV
CATRSSDGGNQPQHF	other
CASSPEGNLYGYTF	NLVPMVATV
CASASLTTVDGQYF	NLVPMVATV
CASSQLTGGEAFF	other
CSAEPGTSGRDDLTQYF	other
CASSLDAGSGYEQYF	NLVPMVATV
CASALVVLDTEAFF	other
CASSQVGPGRANTEAFF	other
CASSRGDTEAFF	other
CASSEGAVSTRQFF	other
CASSRTGSEAFF	other
CSATLTTTGWEKLFF	NLVPMVATV
CASSLGEDSQRVQYF	NLVPMVATV
CASSFEGMSYEQYF	NLVPMVATV
CAISVGTGYEQYF	NLVPMVATV
CSVAQTGGYEQYF	other
CASSFGVGLAGVGLDTQYF	other
CASSGGGGTEAFF	NLVPMVATV
CASRTGVANEQFF	NLVPMVATV
CASSEGGYTGELFF	other
CASSEGQVSPGELFF	NLVPMVATV
CASSPGTVYGYTF	other
CASSLSIRAGELFF	NLVPMVATV
CAMGGEQFF	NLVPMVATV
CASKSQGFAEAFF	NLVPMVATV
CSAERQGGYTF	other
CASRPTGSDTQYF	other
CANSFYFTGAPYNEQFF	NLVPMVATV
CASSPWTGAGDEQYF	NLVPMVATV
CASSLVSGSLDIQYF	NLVPMVATV
CASSWLSDTQYF	other
CASSLGTGFYGYTF	other
CASSIRAGFEQYF	other
CSARGELAAYEQYF	other
CASRQGTGSGAFF	other
CASSQLAGGNTGELFF	other
CSVEFVSSGNTIYF	other
CASSLTYTDRTFQETQYF	NLVPMVATV
CASSEGTNEQFF	other
CASAWTLNTEAFF	other
CASSDYLYEQYF	NLVPMVATV
CASSSPLAPGIDEQFF	NLVPMVATV
CASSPGQSSYEQYF	other
CASSVAKGGHSDDGYTF	other
CASSIRTGQTGELFF	NLVPMVATV
CATSRAAGSYNEQFF	other
CTISEWGGETQYF	other
CASSASGRNSYEQYF	NLVPMVATV
CATSRVSGFGTEAFF	NLVPMVATV
CATSRGQGYEQYF	NLVPMVATV
CASTDLDTGELFF	other
CASIALAETGELFF	NLVPMVATV
CASSDPVRGLEQYF	other
CASSLGVHYEQYF	NLVPMVATV
CAISQRTGGETQYF	NLVPMVATV
CASSLSRNEQYF	NLVPMVATV
CASSPKTYSNQPQHF	other
CASSDPETYEQYF	NLVPMVATV
CSARDPQTGTDFYQPQHF	NLVPMVATV
CASVLGDHRNQPQHF	NLVPMVATV
CASSPFNEKLFF	NLVPMVATV
CSAALRRRGYTF	other
CASSLAGGNNEQFF	NLVPMVATV
CASSDGQGGQDTQYF	NLVPMVATV
CASSPRDRESPEQYF	NLVPMVATV
CASTFKESIVNTEAFF	other
CAWSVLHSYEQYF	NLVPMVATV
CASSPTTRLPETQYF	NLVPMVATV
CSASQGYGNTIYF	other
CASSLIAGTDTQYF	other
CASSTGPDTPPNTGELFF	other
CASSVTGADTEAFF	NLVPMVATV
CASSLAPGATNEKTVF	NLVPMVATV
CASSIMGASPQHF	other
CSARGAGIGNTIYF	NLVPMVATV
CASSMRAAGELFF	other
CASSKGERESELGQETQYF	other
CASSGMSSYEQYF	NLVPMVATV
CASSQNPGGQETQYF	other
CASPGGRLAGNTIYF	NLVPMVATV
CASSIEGAYSYEQYF	NLVPMVATV
CSVSGVSYEQYF	NLVPMVATV
CATEASSYEQYF	other
CSARDPGTGESDTQYF	other
CASSLTGENYEQYF	NLVPMVATV
CASSQYPPENTEAFF	NLVPMVATV
CASSQIMEAPYGYTF	other
CASSFGRRDGRLYEQYF	other
CSVVGGSGYEQYF	NLVPMVATV
CASSIMAGSYNEQFF	other
CASSYRAPGHTEAFF	other
CANPGGYGYTF	other
CASSQDGTTGNEQFF	NLVPMVATV
CASSMGGNPEQYF	other
CASSSSWADTQYF	other
CSARETGTRFYEQYF	other
CASSQDRTGGGYEQYF	other
CASSIRSAHEAFF	other
CASSEAGLGHEQFF	NLVPMVATV
CASSPLEGGYNEQFF	other
CSASSLSGGQTPLGTEAFF	other
CSVEGWDRSSTDTQYF	NLVPMVATV
CASTDGTAFTEAFF	other
CSGGFEYGYTF	NLVPMVATV
CASSLARRVNPRTDTQYF	other
CASSHGTGMTIYF	other
CASSIDGGGPGNEQFF	other
CASSILGKDTQYF	other
CASSMRSAVGQFF	other
CASSQNIYEQYF	other
CAAGVENTGELFF	other
CSVLPGLVYNEQFF	NLVPMVATV
CSARGDQIGSYEQYF	other
CASSLFLAGSYEQYF	NLVPMVATV
CSVRTAISTDTQYF	other
CASSRDRVTDTQYF	NLVPMVATV
CASSLAPSTETQYF	NLVPMVATV
CASSQGPFREEAFF	other
CASSFSQGEQETQYF	other
CASGLGTSYNEQFF	other
CASSVGRTGQGWGNEQFF	NLVPMVATV
CASSGAKDYSGEKLFF	NLVPMVATV
CASSLAGGDTGELFF	NLVPMVATV
CSVEVVGVPYNEQFF	other
CASSEGRTRAKLFF	NLVPMVATV
CASRGDREGTEAFF	other
CSAYQERNEQFF	other
CSATGLLTYNEQFF	NLVPMVATV
CSASTPGEQPQHF	NLVPMVATV
CASSQDPGGPSRTQYF	other
CATTQISNTGELFF	other
CASRPRTGTEAFF	NLVPMVATV
CASSLLADEQYF	NLVPMVATV
CASSFGTGQSSYNEQFF	other
CATSDLKGQGSSYNEQFF	other
CASTAVPYQETQYF	NLVPMVATV
CASSQDLLGNEQFF	other
CASSELAGGQETQYF	other
CSVPGGYTF	other
CSVEGRGTTEAFF	other
CASSLAGGAYGYTF	other
CASSGDSGLSYNEQFF	NLVPMVATV
CASSIRYMGTSLAF	other
CASSLGRGREAFF	NLVPMVATV
CASTPEPGLGPTNEKLFF	other
CSAPWTGLNEQFF	other
CASSARDHSGPNTGELFF	other
CASSQTQFWETQYF	NLVPMVATV
CASSSACYGYTF	NLVPMVATV
CASSQRSAGELFF	other
CASSRGANQPQHF	other
CASSHEGSGGYTF	NLVPMVATV
CASRPGGGYEQYF	other
CASSSMGGDEQYF	NLVPMVATV
CATARGGQETQYF	NLVPMVATV
CASTKTREKLYF	other
CSVEDRGVSYEQYF	other
CASSIFYGTDYGYTF	other
CASSFLGHGRVGELFF	NLVPMVATV
CASSGPDGAWEKLFF	NLVPMVATV
CAIGDRSSGEQYF	other
CASSVDRSSGNTIYF	NLVPMVATV
CSARGGQGQNTGELFF	other
CASSLNRRQNGYTF	NLVPMVATV
CASSQEGTAYEQYF	other
CASSPTGTEAFF	other
CASSLEGGRFQPQHF	NLVPMVATV
CSARAGDTDNSPLHF	NLVPMVATV
CASTARRGSGANVLTF	other
CASSSGYGQPQHF	other
CASSHKGSGGYTF	NLVPMVATV
CASSYSRGSNYEQYF	NLVPMVATV
CASSIGPGLGQPQHF	other
CASSVSARPNGYTF	other
CASSPGLAGGLASTDTQYF	other
CASSLEGLNTEAFF	NLVPMVATV
CASREGYEQFF	NLVPMVATV
CASSIRAGGRNEQFF	other
CASSLGDPRVMSTEAFF	other
CASSSGPAFEAFF	NLVPMVATV
CASRGTSGDTDTQYF	other
CSEGSPYNEQFF	other
CASSVGTTPYEQYF	NLVPMVATV
CASSQGSYEQYF	other
CASSTTRSTLNEQFF	NLVPMVATV
CASSIFSGSMNEQFF	other
CASGTPWEQYF	other
CASSQDPLWRRTGALRGTGELFF	other
CASSLGWGRPNYEQYF	NLVPMVATV
CASSIRNSYEQYF	other
CSATGAPTIDEQYF	NLVPMVATV
CASSQDIPTGSGLLSELFF	other
CAISGWRQGSYEQYF	NLVPMVATV
CASSLGPTGSEQFF	other
CASSWTANTEAFF	other
CASSLYSRAAGQPQHF	other
CSVEWDPPRRGTEAFF	other
CASSIRSTDIQYF	other
CASSLLGPSYNEQFF	other
CASSQVRGGPTEAFF	other
CASSYSRTANEKLFF	NLVPMVATV
CASSPGPDGELFF	other
CASSPFGGSFNEQYF	other
CASSVGAGPYGYTF	other
CASSYRTGRSLHF	other
CSASSGAPVVGTDTQYF	NLVPMVATV
CASSFGAGGNEQFF	other
CASSLGSGQVHEQFF	other
CASSMLALDTQYF	other
CASSIRSGYGYTF	other
CASSYSSGGLQETQYF	NLVPMVATV
CASSQNRGEFEKLFF	NLVPMVATV
CASSTGSGELFF	NLVPMVATV
CASRLSGGAADTQYF	NLVPMVATV
CASSYGSYEQYF	other
CATEDRNTGELFF	other
CASSLGSHDSTNYGYTF	other
CAISESRQGNYGYTF	other
CASQDQNTGELFF	other
CASSLGTEYGYTF	NLVPMVATV
CSVVGVDYTF	NLVPMVATV
CASSEYGNGYTF	NLVPMVATV
CASSSGATEAFF	other
CASSTDLGEKLFF	other
CASSRAVRDDEKLFF	NLVPMVATV
CASGPDLGYTF	other
CASSHLDRTAGADTQYF	other
CASSPWLTSGYTDTQYF	NLVPMVATV
CASTTGANVLTF	NLVPMVATV
CASSFRDRPYEQYF	NLVPMVATV
CASTARSSYNEQFF	other
CASSSTSSTNEKLFF	other
CASSIGLADYNEQFF	other
CASKRGMGTEAFF	other
CASSLNEPLHF	NLVPMVATV
CASSLGSQGGKQPQHF	other
CASSTGTPQFF	other
CASSTGQVSPGELFF	other
CASRFLAGLYNEQFF	other
CASSIVSRDTQYF	other
CSARDDYDLGGTEAFF	NLVPMVATV
CASRIYHEQFF	NLVPMVATV
CASSQDRGSGGHEQFF	NLVPMVATV
CASSFTDTQYF	NLVPMVATV
CASGYRDRGLIEQFF	other
CASSQDRGDAYNEQFF	other
CASSSRGGNNEQFF	NLVPMVATV
CASSGPTNTGELFF	other
CASSLVLTGINYGYTF	NLVPMVATV
CASSPSGVSYEQYF	NLVPMVATV
CASSLSGQGYEQYF	other
CASSLAPEATNEKLFF	NLVPMVATV
CASSQRSATREYF	other
CASSWGTSGSNEQFF	NLVPMVATV
CSARERPSSYNSPLHF	NLVPMVATV
CASSLSLAHEQYF	NLVPMVATV
CSARDLPSGGPQQETQYF	NLVPMVATV
CATSRDRSSGNTIYF	other
CASSDIDTGELFF	other
CASSPDIETQYF	other
CSVEDQLRETDTQYF	NLVPMVATV
CASSHSYEQYF	other
CASSPPDGDQPQHF	NLVPMVATV
CASSPTGTGFVGNTEAFF	NLVPMVATV
CASSIAVTGELFF	NLVPMVATV
CASSLQTSGRHEQYF	NLVPMVATV
CASSRRASYEQYF	other
CASSLEGPKPQHF	other
CATSEGLVGWSAGSSYNEQFF	other
CASSQEDAAYGVNEQFF	other
CASSFGGGTDTQYF	NLVPMVATV
CASSIGRQQFF	other
CASSASTLETQYF	other
CSVPWGSYGYTF	other
CASSDSRQGSYEQYF	NLVPMVATV
CASSQETGLGNQPQHF	other
CASSEYPGGPGETQYF	NLVPMVATV
CSARDLLAGVYNEQFF	NLVPMVATV
CASSQACRGRHRNTIYF	other
CATSGRDMGLAKNIQYF	other
CASSDLSTGELFF	other
CASSLAQGWGAFF	other
CASSPDRGYYEQYF	NLVPMVATV
CASSSRGDSWAETQYF	other
CASSLDPGGNGYTF	other
CASSLIVAGGYNEQFF	NLVPMVATV
CASSQDPGGQETQYF	other
CSARGELSRPYEQYF	other
CASSPGNSGNTIYF	other
CANSLRGSGEQFF	other
CASSLASGASSSYNEQFF	other
CASSIRAPETQYF	other
CASSLTATSGFYNEQFF	NLVPMVATV
CASSFLAENNEQFF	other
CASSPDRTGGTDTQYF	other
CSARDFNSWNTGELFF	other
CSARSAAGINYGYTF	NLVPMVATV
CASSIRSSVMQYF	other
CASSIRVGYEQYF	other
CSVETSGNREQFF	NLVPMVATV
CASSESSGGYYNEQFF	other
CSVATGLDYEQYF	NLVPMVATV
CASSRGGDNEQFF	NLVPMVATV
CASSLDPIITGLAGSYEQYF	NLVPMVATV
CASSQEEGGGYEQYF	other
CASSIGTGFHTEAFF	NLVPMVATV
CASSSSGQPPQETQYF	NLVPMVATV
CASAKRGTDTQYF	other
CASSMGRMNTEAFF	other
CASSFQGGRIGQPQHF	other
CSAKRSRGQPQHF	other
CAWSIERELDEQFF	NLVPMVATV
CAISEGGGVTEAFF	NLVPMVATV
CASSSPQGRLRGGYNEQFF	other
CSASGSYSYEQYF	NLVPMVATV
CASNQVTETGAYDYTF	NLVPMVATV
CSARDGEPYEQYF	NLVPMVATV
CASSPVGGEQFF	other
CSAWTGSATEAFF	other
CASSIRSVGELFF	other
CASSKGGVVNTEAFF	NLVPMVATV
CASSQIGGLAGAHSYNEQFF	NLVPMVATV
CASSSLDVTENTEAFF	other
CASSLRDRRTTDTQYF	other
CASSDRGKQYYEQYF	NLVPMVATV
CASSFSGKLFSGANVLTF	NLVPMVATV
CAISEPGQGDFYEQYF	other
CASSQALGSGANVLTF	NLVPMVATV
CAISEDRSSYNEQFF	other
CASSFRLAGGGNEQFF	other
CASSLDQGGTEAFF	NLVPMVATV
CASSWNSGSYEQYF	other
CASSLGNEQFF	other
CASSPGTTNTEAFF	other
CSARDGGQGGSPLHF	NLVPMVATV
CASSFYFTEAPYNEQFF	NLVPMVATV
CASRAGSFSTDTQYF	other
CASSLGLPGFGTEAFF	other
CSAKLGQDHTGELFF	other
CASSWLAGPYNEQFF	other
CASSQGLAYEQFF	other
CASSSGGMDTEAFF	other
CSVQTGVSGANVLTF	NLVPMVATV
CASSQDIEQYF	other
CASKFTSSWSDTQYF	NLVPMVATV
CASSEQGAPYNEQFF	NLVPMVATV
CASSTRGGTEAFF	other
CASSTLNSLEAFF	other
CASSVQGATDTQYF	NLVPMVATV
CSVAGTADLEAFF	other
CSVMDSISYEQYF	NLVPMVATV
CASSNPGQGGPSYEQYF	NLVPMVATV
CASSLGGSTDTQYF	NLVPMVATV
CASSSRSSDTQYF	other
CSARDLETSGGLETQYF	NLVPMVATV
CASSPLGGNQPQHF	other
CASSLTGGVSGNGELFF	NLVPMVATV
CASSMRSGSKQYF	other
CASNVKIGELFF	NLVPMVATV
CASSYWGALGDTQYF	NLVPMVATV
CASSLRTRELFF	NLVPMVATV
CSATSLAGDNEQFF	other
CSASSWAGGDTGELFF	other
CSVKQGDYNEQFF	other
CASSTGTGYEQYF	NLVPMVATV
CASSQGPGGWTEAFF	NLVPMVATV
CAWSVGAGNTEAFF	NLVPMVATV
CASSNHAGAAQYF	other
CSARDRGNEQYF	NLVPMVATV
CASSLTGSPYNEQFF	other
CASTTGLGQPQHF	other
CSVGDRNNLELFF	other
CASSPQGSHEQYF	other
CASSPSVSVQHRSYGYTF	NLVPMVATV
CASSTRDSNTGELFF	NLVPMVATV
CASSTDSGTDTQYF	NLVPMVATV
CASSVEAGAGVQQYF	NLVPMVATV
CSVGGYGTNEKLFF	other
CSVEGGYSYEQYF	other
CSARDPSGRLWDTQYF	NLVPMVATV
CASSSRVGNIAGELFF	other
CASTMTMGWTEAFF	other
CASSPAGGTYEQYF	NLVPMVATV
CASSQDMGGLSYEQYF	NLVPMVATV
CASSVLQGSGNQPQHF	other
CASSLRQGEAFF	NLVPMVATV
CASSMWGQWGNQPQHF	other
CASSGDNYEQYF	NLVPMVATV
CASSLDESLAGGNEQFF	NLVPMVATV
CAISDLAGVRPDTQYF	NLVPMVATV
CASSLFGGRGSETQYF	other
CASSLRDRGYEQYF	NLVPMVATV
CASSIGLNMGNQPQHF	other
CSADAGGVSYGYTF	other
CASSQEGLGNEQFF	other
CAWSAVRTSANDEQFF	other
CASSSRSSYNEQFF	other
CASSLSTGGALGTIYF	other
CASSQGGTELTYSPLHF	other
CASGLGGESYEQYF	other
CASSLAAGGQYF	other
CASSLPGGYGYTF	NLVPMVATV
CASSLVQRPGNTEAFF	NLVPMVATV
CASSQEYLAAYEQYF	other
CASSEGIMRPGQTPYEQYF	other
CASSPWLTSGRENEQFF	NLVPMVATV
CASSQRGGGIAFF	other
CAWSSQGLGQPQHF	other
CASSLEVGSTEAFF	NLVPMVATV
CASSPPDSSYEQYF	NLVPMVATV
CSVGGGDGYTF	other
CASSPLAGISSYEQYF	NLVPMVATV
CSASTTVGTTMSDEQYF	NLVPMVATV
CASGLDHGYEQYF	NLVPMVATV
CATEDSYNSPLHF	NLVPMVATV
CATSQGGEQFF	other
CATRLGGNNEQFF	NLVPMVATV
CASSQGLPNEKLFF	other
CASRIPGLQETQYF	other
CASRGLVDRTYGYTF	other
CASSTPVRGGETQYF	other
CASSPSGGYNEQFF	NLVPMVATV
CATSDGLAGDYEETQYF	NLVPMVATV
CSVDVGAYEQYF	other
CSAGGLAGALSYF	other
CASSHLAGGYNEQFF	other
CASSLRPTGGSYEQYF	other
CASSSSLSTIYF	other
CASLKKRELAVNYEQYF	other
CASSTLSTDTQYF	other
CSVSLGRLTEAFF	other
CASTPTRGLYEQYF	NLVPMVATV
CASRLPGANVLTF	other
CATSRRTGGGYEQYF	other
CATSREGGAPVSNQPQHF	NLVPMVATV
CASSFWSDNEQFF	other
CASSEVDWVGGADGYTF	other
CASSQTGGLNQPQHF	NLVPMVATV
CNARVEFGTSGQLSSYNEQFF	NLVPMVATV
CSAPGGPNKNTGELFF	other
CASSLVEGLGTGGPRLAEQFF	NLVPMVATV
CASSGAGTKVNEQFF	NLVPMVATV
CASSFGARGRNYEQYF	NLVPMVATV
CASGGPPKSYEQYF	other
CSARVGERAVNTGELFF	other
CASSPEGNTGELFF	NLVPMVATV
CSARDPSGTSNEQFF	NLVPMVATV
CASSSTTGVVTEAFF	NLVPMVATV
CATSRGDTGELFF	NLVPMVATV
CASSVGRTSQETQYF	other
CASSPLAGENYNEQFF	NLVPMVATV
CASSFGGYNEQFF	NLVPMVATV
CASSQEGVLSGYGYTF	other
CASSIFGQGTQYF	other
CASRTSGSYEQFF	other
CASSTDPRGYNEQFF	NLVPMVATV
CASSPSPSLRGKVTYNEQFF	other
CASSSAYYSYTF	NLVPMVATV
CASSQALPYEQYF	NLVPMVATV
CASSQTQPWETQYF	NLVPMVATV
CASRGEDNEQFF	other
CASSLDRAGGSYEQYF	other
CASSQGMGQPQHF	other
CASSIRSVYEQFF	other
CASSQGQGNIQYF	other
CASSQDVSNQPQHF	NLVPMVATV
CASSPDRTGPWEEQYF	NLVPMVATV
CSARDGTGWNTGELFF	other
CASSDSTSGADTQYF	other
CASSSGPDSGNTIYF	other
CASSPLPSGGPDEQYF	NLVPMVATV
CASSERNSLEAFF	other
CAISLEDSSYNEQFF	NLVPMVATV
CASSQEAGLGNHPQHF	NLVPMVATV
CATLSTRVTGELFF	NLVPMVATV
CASGDLDSIEAFF	other
CASTPLGGNTGELFF	other
CSAREGGVQHQPQHF	other
CASSVGDTSYEQYF	NLVPMVATV
CATSRDRYNEQFF	NLVPMVATV
CSARDGRSKDEQYF	NLVPMVATV
CASSGTAYEQYF	NLVPMVATV
CATSDFGTEAFF	other
CASSFFPSFEGISMGTGELFF	NLVPMVATV
CASSVRGGGTDTQYF	NLVPMVATV
CASSFGEGSYEQYF	other
CSARDNLQARYGYTF	NLVPMVATV
CASGWPGGLNSNQPQHF	other
CASSLDYWLYNEQFF	NLVPMVATV
CASSFGVSNQPQHF	NLVPMVATV
CASSLTAGVDTQYF	NLVPMVATV
CASSSSWYGYTF	NLVPMVATV
CASSFLAGGNTGELFF	other
CSVDPDTNYGYTF	NLVPMVATV
CASSPVMNTEAFF	NLVPMVATV
CASSQVAGQGNGYTF	other
CSVTGEERTGELFF	NLVPMVATV
CASSTHTGANYGYTF	other
CASNPTQLGQPQHF	other
CASSPGQGWFF	NLVPMVATV
CASSQDTRRQPQHF	other
CASSLVTGGRYEQYF	NLVPMVATV
CATSDLLTGAHGYTF	other
CASSQGDGGNLYF	other
CASSPWTEAFF	NLVPMVATV
CASSFGTGGQPQHF	NLVPMVATV
CASSYSTPLGIYEQYF	other
CASSQTGAQGEAFF	other
CASSLVGGPADTQYF	other
CASSPHAPGYEQYF	NLVPMVATV
CASSFSEEQFF	other
CSVEKGATEAFF	NLVPMVATV
CASTLAEGTDTQYF	NLVPMVATV
CASSLNIYEQYF	NLVPMVATV
CSARDIEIAYEQYF	NLVPMVATV
CASSLGTGPYEQYF	NLVPMVATV
CASSNVEGTGETQYF	NLVPMVATV
CASSSVNKQFF	NLVPMVATV
CASSLFARSPLHF	other
CASSIQGITEAFF	other
CASSRTGSGELFF	other
CASSLAGGPGNEQFF	other
CASSIVAPTYEQYF	other
CATSAGPSVEQYF	NLVPMVATV
CASNFYFTGAPYNEQFF	NLVPMVATV
CTSSLAPGATNEKLFF	NLVPMVATV
CASSSAAPVSMNTEAFF	other
CSAKTPNYGYTF	NLVPMVATV
CASSHRDTGRNEQFF	NLVPMVATV
CASSLQGFLLSYEQYF	other
CASKERRENHNEQFF	NLVPMVATV
CASSFPSQNTGELFF	NLVPMVATV
CSAPKSWTGDETQYF	NLVPMVATV
CATSRPGGNEQFF	NLVPMVATV
CASSYGDATEAFF	other
CSARNIVGYEQYF	NLVPMVATV
CAIPDIKEGGYTF	NLVPMVATV
CSASFSDTQYF	NLVPMVATV
CASSQDLMGRTSTDTQYF	other
CASTGAGELFF	other
CAWSGSDTQYF	other
CSARDLRGQGDNSPLHF	NLVPMVATV
CASSDLGEQFF	other
CASSFLLAEETQYF	NLVPMVATV
CASSQDPSPQETQYF	other
CASSLAATSGPYEQYF	NLVPMVATV
CASGLRSSYEQYF	other
CASRWTGFSEQFF	NLVPMVATV
CAWSVHEWQANYGYTF	NLVPMVATV
CASSLEIFGGIADTDTQYF	other
CASSLEFDQPQHF	NLVPMVATV
CASSFYFTGAPYDEQFF	NLVPMVATV
CASSFSSYEQYF	other
CASSLASRVGTDTQYF	NLVPMVATV
CAWSVERGIIANYGYTF	NLVPMVATV
CSAFPTATNEKLFF	other
CASRNEQYF	other
CASSVVGGPGEQYF	other
CASSYGDNTEAFF	other
CASRETGVYNEQFF	NLVPMVATV
CANSIRSTETQYF	other
CASSPFHTGELFF	other
CASSVTAGDSEQYF	NLVPMVATV
CASSQGLAEASSYEQYF	NLVPMVATV
CSARDFRGTSGTGELFF	other
CASSTRSDEKLFF	other
CASSIFGGGRNEQFF	other
CAWSVVTDEHNEQFF	other
CASKVTGDVNEQFF	NLVPMVATV
CASSRVLGFRGYGYTF	other
CASSPFGSSLAFF	other
CASSQGIGTGLLTDTQYF	NLVPMVATV
CASSIRGGIEQFF	other
CASNDLDYSYNEQFF	other
CASSIYGGEVEQYF	other
CASSLWSGGSNEQFF	other
CASSFPGASTYEQYF	NLVPMVATV
CASSLGEASYVGQPQHF	other
CASRTSGQGNQPQHF	NLVPMVATV
CASSLQQKFGDEQFF	other
CSARSRGREGPITDTQYF	other
CASSLERTSGTSTDTQYF	other
CASSIDWTSGGLFNEQFF	NLVPMVATV
CASSQDAGGWDEQFF	other
CAGSLVTGTGWGYTF	NLVPMVATV
CAISGGAGGPGEQFF	NLVPMVATV
CASSFGITYEQYF	other
CVSSQEEGPGNQPQHF	NLVPMVATV
CASSIRSSVEQYF	other
CASSIAAYYEQYF	NLVPMVATV
CASKTGGLYNEQFF	other
CASSPYGGAINEQFF	other
CASSGTAVEKLFF	other
CASSSLSGLGYNEQFF	NLVPMVATV
CASSLRVSYEQYF	other
CASSREGGNSPLHF	NLVPMVATV
CASSFRGSGELFF	NLVPMVATV
CASSPDIEAFF	other
CASSIRSSYEAFF	other
CSARPTGAPLSYEQYF	other
CASSLWTGTFNEQFF	NLVPMVATV
CASIGIFNEQFF	NLVPMVATV
CSARGLAGAYEQYF	NLVPMVATV
CASSQGVRTASYEQYF	NLVPMVATV
CASSGGAGGYTF	other
CASSYSGQGVEQYF	other
CASYYQGGANTGELFF	NLVPMVATV
CAISDSETNTGELFF	NLVPMVATV
CASSMVGIHEQYF	other
CATSDPIRASSHGQFF	other
CASSIGMHGYTF	other
CSARAQQSNQPQHF	other
CASSLSLGQAFNQPQHF	NLVPMVATV
CASSIRSTAEQYF	other
CSATPRDRAFPEAFF	other
CASSLHRGKLFF	other
CASNIRSSYEQYF	other
CASSPLTGSEAFF	other
CASSFTTGATNYGYTF	NLVPMVATV
CASSFGGGYREAFF	other
CSAFWDRPYEQYF	NLVPMVATV
CASRLRHRASPLHF	other
CASSIRSSSEQFF	other
CASSQTGFGGAPLHF	NLVPMVATV
CASSIAEQIGEAFF	other
CASSFDRGSAGNTIYF	NLVPMVATV
CASSGTGGKTQYF	NLVPMVATV
CASSFGGRGNYGYTF	NLVPMVATV
CATSSTQSPDGRSGNTIYF	other
CASSFSGGAANEQFF	NLVPMVATV
CASSFTVNYGYTF	other
CSARDSKGNGWNTGELFF	other
CASSIGIESYEQYF	other
CASSRGGTEAFF	NLVPMVATV
CASSQGRNTIYF	NLVPMVATV
CASSYPSRTGTSRDEQFF	other
CASSTYANTEAFF	other
CASHPPGLGDNEQFF	NLVPMVATV
CASRSQEGSNYGYTF	other
CSVEGGRGDTQYF	NLVPMVATV
CASSPGNRGETQYF	NLVPMVATV
CASSLERDEQFF	NLVPMVATV
CASSDGTGLNEKLFF	NLVPMVATV
CASSLNPWGTDTQYF	NLVPMVATV
CASSSKGMDDIQYF	NLVPMVATV
CASSLPGLFEQFF	NLVPMVATV
CASSYSGNSGYTF	NLVPMVATV
CASSLSTDTQYF	NLVPMVATV
CASSSLSGPYEQYF	NLVPMVATV
CASSPFGTGYNEQFF	other
CASSMYGIGNQPQHF	NLVPMVATV
CSARGGGDGANEQFF	other
CSARVDGVLSYEQYF	NLVPMVATV
CASMTHNTGELFF	other
CASSPFGEGGANVLTF	NLVPMVATV
CSVEGRNYGYTF	other
CATDGQSGSGSDEQFF	other
CASSQEPPGQGLAYNEQFF	other
CAAQNLNTGELFF	other
CASSQDSRGSGNTIYF	NLVPMVATV
CASSQNAGDNTEAFF	NLVPMVATV
CASSLAMTDTTDTQYF	other
CASSQGNQPQHF	NLVPMVATV
CASSQDPRASHRGAQYF	NLVPMVATV
CASSQGPSGIGTQYF	other
CASSPRSGSEQYF	other
CASSFETVMSSYEQYF	other
CASSYSRGLDTQYF	NLVPMVATV
CASSIKSGGELFF	other
CSARETSYEQYF	NLVPMVATV
CASSKRSSGELFF	other
CASSLERSEAFF	NLVPMVATV
CSGTGGDDYGYTF	NLVPMVATV
CASSLGRVRSPLHF	NLVPMVATV
CASSQVYVEVREHGELFF	NLVPMVATV
CSARDRDRGYEQYF	other
CASSFYPGGNYGYTF	other
CASSVSWGSGETQYF	NLVPMVATV
CASRDDTGELFF	other
CASSHDLNSYEQYF	NLVPMVATV
CASSLTSGTVKNIQYF	other
CASSPRLLSYNEQFF	other
CASSEEDRVGNQPQHF	other
CASGDRLHEAFF	other
CASSQQGAGQPQHF	other
CAWDLEGGTEAFF	NLVPMVATV
CASSPLDRTIGTDTQYF	other
CASSEGVTPPNSPLHF	other
CSVIGGTGELFF	other
CASRDGGQINETQYF	NLVPMVATV
CAMQEMNTGELFF	other
CASSEPTGTSYNEQFF	NLVPMVATV
CASSPLLSTYNEQFF	NLVPMVATV
CASSFGQGDEKLFF	other
CASSLDTGMTEAFF	NLVPMVATV
CASSIYNTDTQYF	other
CASSLIRENQPQHF	NLVPMVATV
CASSAETQYF	other
CASSRGTAILETQYF	other
CASRAQRGAFF	other
CSVVAGEQFF	other
CASSLRPLTPGQGFYEQYF	NLVPMVATV
CASSEIGSSSTDTQYF	other
CASSMIGGDTEAFF	NLVPMVATV
CASSPGDRTDSPHTDTQYF	NLVPMVATV
CASSGTGGPGELFF	other
CAWSVRESDGYTF	NLVPMVATV
CSARGWETMNTEAFF	NLVPMVATV
CASSIRAAGTQYF	NLVPMVATV
CASLGQGNEQYF	NLVPMVATV
CASRLAGVGEQYF	NLVPMVATV
CASSLGGPLYEQYF	other
CASSLLAGVQTGELFF	NLVPMVATV
CASRTVNPPLHF	other
CASSARNSIEAFF	other
CASSLPTSGSSTDTQYF	NLVPMVATV
CASVGGRSYNEQFF	NLVPMVATV
CASSTNRASNQPQHF	NLVPMVATV
CASSGKGPEEVSTQYF	NLVPMVATV
CASSLEVAGGLTDTQYF	NLVPMVATV
CASSLGSRNEQFF	other
CASSTDRTYNEQFF	NLVPMVATV
CASSPVGTEAFF	other
CASSQGPVGTEAFF	other
CASSSGREREETQYF	NLVPMVATV
CSVPEEGTDTQYF	other
CSAQAGTSETGELFF	NLVPMVATV
CASSPDIEDFF	other
CAWSGGTGNTGELFF	NLVPMVATV
CASCFMNTEAFF	NLVPMVATV
CASSIRTAGDEAFF	other
CASSKIEQPQHF	other
CASRAGELDTDTQYF	NLVPMVATV
CASSLTGMWETQYF	NLVPMVATV
CAWSVGTGAYEQYF	NLVPMVATV
CSARDYRGGTTYEQYF	other
CASSMGIYGYTF	other
CSARLAESSYEQYF	other
CASNQRGGRNEQFF	other
CASSVGAPRNSPLHF	other
CASSRGGQGWGTDTQYF	other
CSVRTGTRSFSGELFF	NLVPMVATV
CASSRGQLEQYF	NLVPMVATV
CASSPHRDFYTDTQYF	other
CASSEDLRTEAFF	NLVPMVATV
CSARLAGDTGELFF	NLVPMVATV
CASSIEAGGTDTQYF	other
CASSLGIVEQFF	other
CASSPPTLEDSGANVLTF	other
CASSHPLNTEAFF	NLVPMVATV
CASSLWTGGGEQYF	other
CASSDRASTDTQYF	NLVPMVATV
CTSSPRDRGNTGELFF	NLVPMVATV
CASSLWDRSSGANVLTF	NLVPMVATV
CASSQDLAGHTGELFF	NLVPMVATV
CATSEQGQGPSDTQYF	NLVPMVATV
CASNGRVQYEQYF	NLVPMVATV
CASSWTTGTGGFYNEQFF	NLVPMVATV
CASSVFGNPGAGANVLTF	NLVPMVATV
CASSFEGNTGELFF	other
CASSSYRENTGELFF	NLVPMVATV
CASMGQGPYEQYF	NLVPMVATV
CASSSFGVNGYTF	other
CASSPQVSGANVLTF	other
CSARGLAGVNEQFF	other
CATRQGADSEQFF	NLVPMVATV
CASSILGSSRNEQFF	other
CASSLAFSYNEQFF	other
CASSTPPGVNSNQPQHF	other
CASSSGFYEQYF	other
CASSIGSYGSTF	other
CSVEHDTEAFF	NLVPMVATV
CASSSDAQVYEQYF	other
CASSQDQEGLRDTQYF	other
CASSLGLGTGELFF	other
CASSVQNTGELFF	other
CASSGQGATEAFF	NLVPMVATV
CSASNPGTGDSGELFF	NLVPMVATV
CASSPRLAGEINNEQFF	NLVPMVATV
CSAHPNSGSSYNEQFF	other
CSARDLGLAGGPRETQYF	other
CASSIRADYEQYF	other
CASTNSESSYNEQFF	NLVPMVATV
CASIVPENYGYTF	NLVPMVATV
CASSVEGTVTDTQYF	other
CSARDYLSDRLHEKLFF	NLVPMVATV
CASSLGGAIDEQYF	NLVPMVATV
CASSNLPGTGEAFF	NLVPMVATV
CASSFSGTDTQYF	NLVPMVATV
CSVQRPAAYNEQFF	other
CASRRDRGLEVSDTQYF	other
CASSRQTGTSYGYTF	NLVPMVATV
CASSLLQGTEAFF	other
CSVARQGGDEQFF	other
CAWSVVAGGEGQFF	NLVPMVATV
CSASGGTSYNEQFF	NLVPMVATV
CASSLVGVGEQYF	other
CSASYPSVNTEAFF	other
CASSLSPGQGDTQYF	NLVPMVATV
CASSPQVLSSYNEQFF	NLVPMVATV
CASSQDGGVRQYF	NLVPMVATV
CASSDWDGINLAGAFPWETQYF	other
CASSLANLVEETQYF	NLVPMVATV
CSARDSSGSRLTLAETQYF	NLVPMVATV
CASSIRGGSSYNEQFF	other
CASSLVASGGPPYEQYF	NLVPMVATV
CASGTRSADTQYF	other
CASMRGSSYNSPLHF	other
CASGYQRGATYEQYF	NLVPMVATV
CASSRLAGIGYEQYF	NLVPMVATV
CASSPVTGQGYYGYTF	NLVPMVATV
CASSFHGLAGEETQYF	other
CAWSVPDTSSTDTQYF	NLVPMVATV
CASSVGTVKNQPQHF	other
CAASTGSYGYTF	other
CASSYQTGTGNYGYTF	NLVPMVATV
CAISALAGVDEQFF	NLVPMVATV
CASSMTSLNEQFF	other
CSVESETGGLNEQFF	NLVPMVATV
CASSPPMPGRNEAFF	other
CASSIIGGGNTGELFF	other
CSFRTGVDTQYF	other
CSVDGSLAGRSYEQYF	NLVPMVATV
CASSAGDGTDTQYF	NLVPMVATV
CASSLEGSYEQYF	other
CASSYSMGSNQPQHF	other
CASSSGQGGDTQYF	NLVPMVATV
CASSFNFYEQYF	NLVPMVATV
CSANPSSGQYNEQFF	NLVPMVATV
CASTETGLMNTEAFF	other
CASSLIPGPEQFF	NLVPMVATV
CASSQRLAGLTDTQYF	other
CASSSEDYEQYF	NLVPMVATV
CASSIRAQETQYF	other
CASSALAGPGNEQFF	other
CASSGRDNYNEQFF	other
CASSFGTGLTYEQYF	other
CASSTGLWGYTF	other
CASEGRGARNQPQHF	other
CASSHLGPGGPSYEQYF	NLVPMVATV
CASSVSGGLTDTQYF	other
CSVVSSGYTF	other
CASSQDTGSTEAFF	other
CSALRNTQYF	NLVPMVATV
CASSSLLNTEAFF	other
CAIRDSFSYNEQFF	NLVPMVATV
CASNLAGAREEQYF	NLVPMVATV
CASSQDIRQNTGELFF	NLVPMVATV
CSARGLADFVDTQYF	NLVPMVATV
CASSLDGAYNEQFF	NLVPMVATV
CASSHLQGSHGYTF	NLVPMVATV
CASSLRTGAGAYGYTF	NLVPMVATV
CSSSYSRQWNTEAFF	NLVPMVATV
CVSSSAYYGYTF	NLVPMVATV
CASSGTPKDYEQYF	other
CASSLGGAVYEQYF	other
CSARDLIGAGANVLTF	NLVPMVATV
CASSYGGSYTF	NLVPMVATV
CASANPVAVSTGELFF	NLVPMVATV
CASSQAGVAEQFF	NLVPMVATV
CASSQVTGDGKLFF	other
CASSELAGGAFGNQPQHF	other
CASSLMDSKTYEQYF	NLVPMVATV
CASSQTGTDTEAFF	NLVPMVATV
CASSSSYEQYF	NLVPMVATV
CASSTGDSNQPQHF	other
CASSLRVSEQFF	other
CASSLALSRIYNEQFF	NLVPMVATV
CASSKVGTVDQPQHF	other
CASSWRSTGELFF	other
CATSGGTGHQPQHF	other
CASSYSSTRATSNQPQHF	other
CASSEGQGHQPQHF	NLVPMVATV
CASSLRQGARGYTF	NLVPMVATV
CSVGDGNTEAFF	NLVPMVATV
CASSPGGGNQPQHF	NLVPMVATV
CSARDHEGSNYGYTF	other
CASSGELGDTQYF	NLVPMVATV
CASSFRSSGRQAYEQYF	other
CASSWGDTYEQYF	other
CASSQEGIGLSTTNSPLHF	other
CASSLAGVGEQFF	other
CATRQYSGNTIYF	NLVPMVATV
CASSLGQGHQPQHF	other
CASSLIFPGELFF	other
CASSQVWDSTNYGYTF	NLVPMVATV
CASRRGFEQYF	other
CASSLHRAEAFF	other
CASSISGGYYNEQFF	NLVPMVATV
CASRWMNTEAFF	other
CASSQDSSGVYEQYF	other
CASSTGYYGYTF	other
CASSLTAGGGNSPLHF	other
CASSLTHELEQYF	other
CASRPDRGSNQPQHF	other
CRMRGPANTEAFF	other
CASSKPTDSPNEQFF	other
CASSATGTGELFF	NLVPMVATV
CASSKAHRVSRRPQHF	other
CASSPITGTNEKLFF	NLVPMVATV
CASSYDRANYGYTF	other
CSAREGSYEQYF	other
CSARDHKAMNTGELFF	other
CAISESRRAISEQFF	other
CASSRTRAGGPQHF	other
CASSPQGDGEKLFF	NLVPMVATV
CASSTGHTDTQYF	NLVPMVATV
CASSWFQGNEQFF	other
CSARPRPGQGHYSNQPQHF	other
CASSQRQGPYNEQFF	NLVPMVATV
CASSLEPNYGYTF	NLVPMVATV
CASSLYGRRETQYF	NLVPMVATV
CASSAGGMGYGYTF	other
CASSIVASGAGGELFF	other
CASSFGLADYEQYF	NLVPMVATV
CASSIISVGEQFF	other
CSAREDQRAQETQYF	other
CATMDDLNSGELFF	other
CSVVLAGGPDTDTQYF	other
CASSQDGQGETGELFF	other
CASYTLGYTNTGELFF	other
CASSLTSGSSYNEQFF	NLVPMVATV
CASSFGDEQFF	other
CASSIEDLTNYGYTF	other
CASSYGTSRYNEQFF	NLVPMVATV
CASSIIAGENIQYF	other
CASSWAGTGDSPLHF	other
CASSSWTSGRTSSANEQFF	NLVPMVATV
CASIPSRQGAGDTQYF	NLVPMVATV
CASRLRDGLYTEAFF	NLVPMVATV
CASSPLGGAGEDTQYF	NLVPMVATV
CASSEGGGGNTIYF	NLVPMVATV
CASSRGGTGDQPQHF	other
CAWSVDGLNPLGYTF	NLVPMVATV
CASSVGTGPNLQETQYF	NLVPMVATV
CASSLGETTEAFF	NLVPMVATV
CATSRDQGDSNQPQHF	NLVPMVATV
CASSLNRDEQYF	NLVPMVATV
CSAETSDSYEQYF	other
CASSSPGQGGSETQYF	other
CASSFPLGGTYEQYF	NLVPMVATV
CASSPGGLTDTQYF	NLVPMVATV
CSVTNPGGVLGYEQYF	NLVPMVATV
CASSGGQGPSEAFF	NLVPMVATV
CASSESWDRNSPLHF	NLVPMVATV
CASSIGHNEQFF	other
CASIPPGGTEAFF	NLVPMVATV
CASRGLAEQNTGELFF	other
CACPSGVEQFF	other
CAILGFFSTGELFF	NLVPMVATV
CASSHRATGELFF	other
CASSAGQISRVTQYF	other
CARSLDGNEQFF	other
CASRNGTGLRDTEAFF	other
CASSDSRQGAFRRETQYF	other
CASSPPLTGELFF	NLVPMVATV
CASSYSSSGGPFATQYF	other
CASSGRQTAVMSSYEQYF	NLVPMVATV
CASRGGGELFF	NLVPMVATV
CASSTGVAEQYF	other
CASSLGGGMGYTF	other
CASSRVIGAHTDTQYF	NLVPMVATV
CASSVDRLGYGYTF	NLVPMVATV
CASSPWDRQTSYEQYF	NLVPMVATV
CASSSGGEQYF	NLVPMVATV
CASSFYFTGTPYNEQFF	NLVPMVATV
CASTRGGETQYF	NLVPMVATV
CASRGGSKPFNEQFF	NLVPMVATV
CASSELGTSNEQYF	other
CATSRDYRDRGAWRWEKLFF	NLVPMVATV
CASSHGAGTDEKLFF	other
CASSSSGGELFF	NLVPMVATV
CAWSPGPVNEQFF	other
CASSVSGTGELFF	NLVPMVATV
CATFSGNTGELFF	other
CASSSGSYYEQYF	NLVPMVATV
CASSLAGQGATDTQYF	NLVPMVATV
CASSEGTDTQYF	NLVPMVATV
CASSSQGQGHVNTEAFF	other
CASRLLAGPSYEQYF	NLVPMVATV
CASSTRSHDIQYF	other
CASRQGPTEAFF	other
CACLTGATNEKLFF	NLVPMVATV
CASSLNPSTDTQYF	other
CASSMSSGTEQYF	other
CASRPDRERQAGGYTF	other
CASSPLYEQYF	other
CSARGTGTSYEQYF	NLVPMVATV
CSASGETLGYEQYF	NLVPMVATV
CASGFGNTEAFF	NLVPMVATV
CASMRGDNEQFF	other
CATSKDRVSEQYF	NLVPMVATV
CSASPHPQEGIGELFF	other
CSARPPGTPPYEQYF	NLVPMVATV
CASSFLVETQYF	other
CASSPTSGRDRSGQFF	NLVPMVATV
CASSVAGGFTDTQYF	other
CSVGMDGVTNEKLFF	other
CASSRWGLNNEQFF	other
CSARAGGEPQHF	other
CAWSRGGWGHNEQFF	NLVPMVATV
CASSSSGGANEQFF	other
CAWRQGFSTDTQYF	NLVPMVATV
CASKAFMNTEAFF	other
CASSLWGGEKLFF	NLVPMVATV
CASSRGPLNTEAFF	other
CASSYTTNYGYTF	other
CASSFGLYEQYF	other
CASSSRSGVEQFF	other
CASSPTGTGEAFF	other
CASSTYSQDTQYF	other
CASSMRSAHEQYF	other
CASSAWLPLNYEQYF	NLVPMVATV
CASNQPLAYNEQFF	other
CASSLLGDTGRTEAFF	NLVPMVATV
CASSLPGLAGDRAYEQYF	other
CASTLAGFNVYNEQFF	other
CASSYSAVNTEAFF	NLVPMVATV
CSASSPDTDSYEQYF	NLVPMVATV
CSVESLDRGETQYF	NLVPMVATV
CASSFPTSGETQYF	NLVPMVATV
CASSLDWRGADSPLHF	other
CASSTRNYNEQFF	NLVPMVATV
CASSPTDTQYF	NLVPMVATV
CASSFRDSTGELFF	NLVPMVATV
CASSLSEMSSYEQYF	NLVPMVATV
CASSFWWGSTDTQYF	NLVPMVATV
CASRIRAAETQYF	other
CASSPGDLPWGQPQHF	other
CASSPDGSQETQYF	NLVPMVATV
CSVLGGWGMNTEAFF	other
CASSPRDRRDEQFF	other
CASSESWGTANYGYTF	other
CASSSPNIIRDPTGELFF	other
CASSPGQGAWEQYF	other
CASSKRSTDEQFF	other
CANSIGQVDTIYF	other
CAWSGGLNTEAFF	NLVPMVATV
CASSYSSGLVSSEQYF	other
CASSLGSGGSYEQYF	NLVPMVATV
CASSPSGVSYNEQFF	NLVPMVATV
CSAREEAGTSGRRASYEQYF	NLVPMVATV
CSARGLGLAGVLEYF	NLVPMVATV
CASSSTRTWDTEAFF	NLVPMVATV
CASSVVGNEQFF	NLVPMVATV
CASRGTSNHEQFF	NLVPMVATV
CASSLFQETQYF	other
CASSLEGQASSYEQYF	other
CASSLHEGNEQFF	other
CASSFRDRSQPQHF	NLVPMVATV
CASSVEGNEQFF	other
CASGTQNTGELFF	other
CASSTGQHYEQYF	NLVPMVATV
CASSDYRENSPLHF	NLVPMVATV
CASSWETNTEAFF	NLVPMVATV
CASSFGLHDYTF	other
CASSPTASTDTQYF	NLVPMVATV
CASTQDIEAFF	other
CASRTGEWPETQYF	other
CASSPSRDLAWGFEKLFF	other
CASSGVSNQPQHF	other
CASSPGQGATGELFF	other
CASSVDGDTYTDTQYF	NLVPMVATV
CSVEEVAGGPGEQFF	other
CASKAAGFREQYF	NLVPMVATV
CASSLGRGYEQYF	other
CSAPLTGNEQFF	NLVPMVATV
CASSGLNTGELFF	other
CASSLGENTGELFF	NLVPMVATV
CSSRTSGDNEQFF	NLVPMVATV
CASSQERRSTDTQYF	other
CASSYSGRFREQFF	NLVPMVATV
CSVERDTEAFF	NLVPMVATV
CASSIFSGGYNEQFF	other
CASSLGNSSGQPQHF	NLVPMVATV
CASSLAGQTHSGNTIYF	NLVPMVATV
CASSIGWQTQYF	other
CASSFQERTDTQYF	NLVPMVATV
CASSIRSHYEQYF	other
CASSQVQSSYNEQFF	NLVPMVATV
CASSDSAGQGDTGELFF	NLVPMVATV
CASSSGTVYNEQFF	other
CASSLGTGGLFGEQYF	NLVPMVATV
CASSPPGTGVYGYTF	other
CAIREPHKGGNYEQYF	NLVPMVATV
CSASGVRNEQFF	NLVPMVATV
CASSQWGSGANVLTF	NLVPMVATV
CASSLGASGIRNEQFF	NLVPMVATV
CASSPGTGTYEQYF	other
CASSLGDQPQHF	other
CASSIYSGVWNEQFF	other
CASSHTQERANTGELFF	other
CASSQVEGPGNQPQHF	NLVPMVATV
CASSQDKAGNTEAFF	NLVPMVATV
CSAQTGGRAETQYF	NLVPMVATV
CASSQAGGAYGYTF	NLVPMVATV
CASSPYPRGGTGELFF	other
CASSPTYGTGGGQPQHF	NLVPMVATV
CASPGPYEKLFF	NLVPMVATV
CASSPDREGTDTQYF	NLVPMVATV
CASRSGGAGGEQYF	NLVPMVATV
CASFFRRDGDNQPQHF	NLVPMVATV
CASSPGHIDTQYF	NLVPMVATV
CASSPAGPGSPLHF	other
CASSLAGTDIYEQYF	NLVPMVATV
CSASPTSGASPNEQFF	NLVPMVATV
CASSIRWAYEQYF	other
CASSTRSTDTLYF	other
CSASPSYLNTEAFF	other
CASSFNSEGYEQYF	NLVPMVATV
CASSLVGVDEQFF	other
CSARTGDDWNTGELFF	other
CASSWGSWGYTF	other
CASSQDLGGTEAFF	NLVPMVATV
CASSPYNEQFF	other
CASSPSASGSSYEQYF	other
CAISEPTEWAGELFF	NLVPMVATV
CASSLYGPLSTDTQYF	other
CASSQGTLKGTEAFF	other
CSAGGARHEQYF	other
CATSREESGPYNEQFF	NLVPMVATV
CASNQTQLWETQYF	NLVPMVATV
CSAPRTGSNEQFF	NLVPMVATV
CASSLFPGPYNEQFF	NLVPMVATV
CASSGDFATSYKQYF	other
CSANLGNQPQHF	NLVPMVATV
CASSSEGDTEAFF	NLVPMVATV
CASSGTDRGGGYTF	other
CASSQLGTAYGYTF	NLVPMVATV
CASSSPEAGIGELFF	other
CASSLSLGKF	NLVPMVATV
CSARVYGYTF	NLVPMVATV
CASSFGGLYGYTF	other
CASSLLTSGGPDTQYF	other
CASSLVQGDNYGYTF	other
CASSFEASVSTDTQYF	other
CASRSGAEAFF	other
CASSLEGGAKNGYTF	other
CASSLGLDTQYF	NLVPMVATV
CASSLRDWNEQFF	NLVPMVATV
CSAGDRNTGELFF	other
CASSISGTGNEQFF	other
CAISELAGVHEQYF	NLVPMVATV
CASSPGGRTDGPHTDTQYF	NLVPMVATV
CASSITGPDTQYF	other
CASSRLYGNTGELFF	NLVPMVATV
CASSIRSVGEQYF	other
CASSLSGNSPLHF	NLVPMVATV
CASSSAGGGRDRDYEQYF	NLVPMVATV
CASRHEGLGGYGYTF	other
CSATKGHYNSPLHF	other
CASSDPPAEFNEKLFF	NLVPMVATV
CASSLGQVAFYEQYF	other
CSAEAGLPYYEQYF	other
CASSYSSTASGANVLTF	NLVPMVATV
CASSLLVGWNTEAFF	NLVPMVATV
CASSDTTRQNTGELFF	other
CASSILAGYTSTDTQYF	NLVPMVATV
CASSEETRASETQYF	other
CASSPLDVTENTEAFF	other
CASSLQGLGNTIYF	other
CASSETGSTYEQYF	other
CASTPGELAGGGETQYF	NLVPMVATV
CSARDQDGSLIGEQFF	NLVPMVATV
CASSLAQHEQYF	NLVPMVATV
CASSQYSGGYEQYF	other
CASSITGDSSYNEQFF	other
CASGQGDNEQYF	other
CASSIFWRGEQFF	other
CASRSTGSQETQYF	other
CASSFKTGDQGYTF	NLVPMVATV
CASKLIRGVTEAFF	NLVPMVATV
CASSEYGGPNSPLHF	NLVPMVATV
CSVRQANTGELFF	NLVPMVATV
CSVAGNTEAFF	other
CSARGTGHSSYEQYF	other
CASSARGDEQYF	other
CASSGNRAPVYDEQFF	other
CASSLPDSNEQFF	other
CASSPSRILTGETEKLFF	other
CSVENTFEAFF	NLVPMVATV
CASSQDLGTLQPQHF	NLVPMVATV
CASSQDWGSSYEQYF	NLVPMVATV
CASSLTAGPTDTQYF	other
CASSLWDTREQYF	NLVPMVATV
CSASPKGAIYNEQFF	NLVPMVATV
CATSDLWRQGGPDTQYF	NLVPMVATV
CASSYTTSGRSEQYF	other
CASSLTPTGSTDTQYF	other
CASSLSDRVGEQYF	other
CASSGTSGGQGYTQYF	NLVPMVATV
CASIGLNTGELFF	other
CASSPGTGGNSPLHF	other
CSVGTYGTNEKLFF	other
CASSMVSTDTQYF	other
CASSPPVGEQTQYF	NLVPMVATV
CSARDAIRRRGWNEQFF	other
CASSPSTYTDTQYF	NLVPMVATV
CASSQTGQSRTSGSTDTQYF	NLVPMVATV
CASSFSGEQYF	NLVPMVATV
CASSLSMGEKLFF	NLVPMVATV
CASNQGGISYGYTF	other
CASSYLRGSPLHF	NLVPMVATV
CASSLPTENTDTQYF	other
CASSNAGTQYGYTF	other
CASSLEPKAPYEQYF	NLVPMVATV
CASSLSSGTRLAPLHF	NLVPMVATV
CSVEVGSNQPQHF	NLVPMVATV
CSANAEAYQETQYF	other
CASSLERGLTRETQYF	other
CATSDLPVDSYTDTQYF	NLVPMVATV
CASSDMNTGELFF	other
CSVTGDNYGYTF	other
CASSPWGGQHYEQYF	NLVPMVATV
CASSPSGLAGLTDTQYF	other
CASSYSAGGSYNEQFF	NLVPMVATV
CASSVDNTGELFF	other
CASSPSGRYNEQFF	NLVPMVATV
CASSIRSTKTQYF	other
CASTPGSLYYGYTF	other
CAWSSNRPLLSYNEQFF	NLVPMVATV
CASSQGSGVGEQFF	NLVPMVATV
CASSPRSSGPQHF	other
CATRPRTGGNEAFF	other
CASSQDRDRVREQYF	other
CASSQVGRPDTQYF	other
CSASGTGSNYGYTF	NLVPMVATV
CASSFSTDTQYF	other
CSVEVGVVSETQYF	NLVPMVATV
CASSPRGKEKLFF	other
CASSKQTGTGETKNIQYF	other
CASSLYGLAGDGEQYF	other
CSALTPALAGGVPETQYF	other
CASGQGGTEAFF	NLVPMVATV
CAWSEDNEQFF	NLVPMVATV
CASSGNWEVGEAFF	other
CASSEYAGRSYNEQFF	other
CASSPSFGELFF	other
CATSLWNTEAFF	other
CASSMYSTDTQYF	other
CASNQGPEAFF	NLVPMVATV
CASSQEGPNQETQYF	NLVPMVATV
CASSVRATDTQYF	other
CASSPRRAGAANTGELFF	other
CSAEREISYEQYF	other
CSASSGGPTDTQYF	other
CASTDLNTGELFF	other
CASSLEWDRVYEQYF	NLVPMVATV
CASSEQSNQPQHF	other
CASSQVPIENF	other
CSAPILGGVYTEAFF	other
CASSQDGGGGLETQYF	NLVPMVATV
CASSPFGTRELFF	other
CASSVSAGIGYEQYF	NLVPMVATV
CATSDSSYSGNTIYF	other
CASSDHLVAGANYGYTF	other
CASSIRSGQPQHF	other
CASALAGGPGGELFF	NLVPMVATV
CASSVMLGETQYF	NLVPMVATV
CASSSHGADTQYF	other
CASSYWDRGSGANVLTF	NLVPMVATV
CASSLEGYGSTYEQYF	NLVPMVATV
CASSLWARGYQETQYF	NLVPMVATV
CAWSLMAGGELFF	NLVPMVATV
CASSLGTGTEAFF	other
CASTGGPGYGAQYF	other
CASSPPRAENTIYF	NLVPMVATV
CASSIRAAAEAFF	other
CSGGRGETCNQPQHF	other
CATRDLTAGELFF	NLVPMVATV
CASYDLNTGELFF	other
CASRATGDLYEQYF	other
CASSPPGGLYEQYF	other
CASSQVYGAPDQPQHF	NLVPMVATV
CASSRTGRTDTQYF	NLVPMVATV
CASSQESLAGRGAYNEQFF	other
CSGAGVVAGGFNTGELFF	other
CSARDFEITGELFF	NLVPMVATV
CASSSRAGGDTQYF	other
CASSIFHQKEAFF	other
CASSPSGVDQYF	other
CASSLYKGIQETQYF	other
CASSHQPRLTEAFF	other
CASSETGGTEAFF	NLVPMVATV
CASSDQSLGPDTEAFF	NLVPMVATV
CASSERVGETQYF	other
CSARDKSLPTEAFF	NLVPMVATV
CASSLGLSSYNEQFF	other
CSARDQDISDTQYF	NLVPMVATV
CASSYAAGDNEQFF	NLVPMVATV
CASSHTGPGYGYTF	other
CASSMRSAWEQFF	other
CASSLEAGGPTEAFF	NLVPMVATV
CASSDAQASLSNYGYTF	NLVPMVATV
CAISESVQGLAKNIQYF	NLVPMVATV
CASSLVETGELFF	other
CATSPYRGADTQYF	other
CAEGQGETQYF	other
CCQKRERLWAEGYNEQFF	other
CASSYTSGAEQYF	NLVPMVATV
CASSRYSLDTQYF	other
CASSIFGGGYNEQFF	other
CASSLVSGGFTDTQYF	NLVPMVATV
CASSYSSLGYEQYF	other
CASSSEQTFYGYTF	NLVPMVATV
CSARDHRGANTGELFF	other
CANSQQGSSYEQYF	other
CASSIVPLDTQYF	other
CASRQRPEAPNTEAFF	NLVPMVATV
CASSARASGELFF	other
CSATLLGLWGDEQFF	NLVPMVATV
CASSFLGDSAFF	other
CASSFGRGSYEQYF	other
CASSLRTRSSGANVLTF	other
CASSLTCDRTHSVYGYTF	other
CASSLEDSTDTQYF	NLVPMVATV
CASSFPSDGSSYNEQFF	NLVPMVATV
CASSDPATEGAFF	other
CASSILGSSNQPQHF	other
CASSPSGDSRHF	other
CSATTAGDYEQYF	NLVPMVATV
CASSFVGDGDEQFF	NLVPMVATV
CASSFTGNSPLHF	other
CSVEDSSYGYTF	other
CASSATDAYEQYF	NLVPMVATV
CASRGGQGAYNEQFF	NLVPMVATV
CASTQSPLAGNEQYF	other
CASSQERAGQETQYF	other
CASGRQNTGELFF	other
CASTQGQGNQPQHF	NLVPMVATV
CASSIVTGYGYTF	other
CATSRGTSGGSDTQYF	NLVPMVATV
CASSSLGGRGDTQYF	other
CASSENWDNTDTQYF	NLVPMVATV
CSARSGTGGDYTF	other
CSASALDRTGATASGRERDLEAFF	NLVPMVATV
CASSFGQATYNEQFF	other
CASSMGPGEWPQHF	NLVPMVATV
CSARGRAAGTDTQYF	NLVPMVATV
CASSSAPEGLSYEQYF	other
CASSLALAGITDTQYF	NLVPMVATV
CSVVLDSRYEQYF	NLVPMVATV
CASSQRARAKNIQYF	NLVPMVATV
CASSFQSDNEQFF	other
CASTQGSTDTQYF	other
CASSPGTGDNQPQHF	NLVPMVATV
CASNPGWDTGRKAFF	other
CASSSGTSYNEQFF	NLVPMVATV
CASSKIWGQGVDTEAFF	NLVPMVATV
CASSTRPGLKSSYNEQFF	NLVPMVATV
CASSQGLAETQYF	NLVPMVATV
CASSYSLGWQQKLFF	NLVPMVATV
CASGYYSGGGSAFF	NLVPMVATV
CASSSVVAGNSPLHF	other
CSARDGLAGGVGELFF	other
CASSTFDGSYEQYF	other
CASSYTLTGLNTEAFF	NLVPMVATV
CASSTRTSGSYNEQFF	NLVPMVATV
CASSFSLPYKQYF	NLVPMVATV
CSAITDRTYSNQPQHF	other
CATSDGRSGFLNTGELFF	NLVPMVATV
CATQDANTGELFF	other
CASSLAGAPSGEQYF	other
CATSARDRGISPLHF	NLVPMVATV
CASSLVRGDEQFF	NLVPMVATV
CASSSRGANEQFF	other
CASSMRSSGELFF	other
CSADMSLENEQFF	NLVPMVATV
CASSQGTSGGETQYF	other
CATSIDRGREKLFF	other
CASSLSSRDTGELFF	NLVPMVATV
CASSEGPYTGELFF	other
CASILLRIVGQLNEKLFF	other
CSVPTGKTYNEQFF	NLVPMVATV
CATSTYDNPTDTQYF	NLVPMVATV
CASSQSTGANVLTF	other
CASSLRRAGFGQETQYF	other
CASSPQSNQPQHF	other
CASSEGSTWDSYGYTF	other
CASSFMGPAGKLNTGELFF	NLVPMVATV
CAWSEGTGLYEQYF	NLVPMVATV
CASGTYSNQPQHF	other
CASSLVYEQYF	NLVPMVATV
CASSIFGQGEQYF	other
CASRDSAVTGELFF	other
CSASPGAESSYEQYF	NLVPMVATV
CASSQTGGGEQYF	NLVPMVATV
CASSQGAVGLDDYGYTF	other
CASSLSTQGATEAFF	NLVPMVATV
CASNQGNTGELFF	other
CASSIFGGQIYEQYF	NLVPMVATV
CASSLEIAGGNYNEQFF	NLVPMVATV
CASSLPRFPYEQYF	NLVPMVATV
CASSPEGGAIVAPEAFF	other
CASSMTGVYEQYF	other
CSARDPGLAAYNEQFF	NLVPMVATV
CASSWRFGTSSSYEQYF	NLVPMVATV
CASSREAGGYEQYF	other
CASSQFVLGDQDLNEQFF	NLVPMVATV
CASSEGANTEAFF	other
CASSMGANEQFF	other
CASSYSATGGEQYF	other
CASGPGTVSYEQYF	other
CAISTGDSNQPQHF	other
CATSRAGQGGGYTF	NLVPMVATV
CASSLEQGDAEAFF	NLVPMVATV
CASSTHSTYEQYF	other
CASSKEVAGYEQFF	NLVPMVATV
CASRLQTGTIYGYTF	NLVPMVATV
CAWSVPDGNYGYTF	other
CASSLVWTGEETQYF	other
CASSEDHTEFYEQYF	NLVPMVATV
CAIGGGLADTQYF	NLVPMVATV
CASSLTTSPGEQYF	NLVPMVATV
CAGSIRSTETQYF	other
CASSLLSSAGEAFF	other
CSARPRDRGINEQFF	other
CATKTTSGGYNEQFF	other
CSNQPQHF	other
CSASTGADTGELFF	NLVPMVATV
CASSLIPGAFF	NLVPMVATV
CASSYSPEAYEQYF	NLVPMVATV
CASSSILAGDADEQFF	NLVPMVATV
CASSPSPPATDTQYF	NLVPMVATV
CASSARLAGGGNEQFF	other
CASSPSRFLRGALETQYF	NLVPMVATV
CSAWDRRLNTEAFF	NLVPMVATV
CASSLLQQGGIDTQYF	NLVPMVATV
CSVEGAGGYDEQFF	other
CSAPSGSSYEQYF	NLVPMVATV
CASSYPDRGHSNQPQHF	other
CASSLNRGGSYEQYF	other
CASSQDRGYTF	other
CSVATGYYGYTF	NLVPMVATV
CASSLWGRSNYGYTF	NLVPMVATV
CASSSDGGLWDTEAFF	NLVPMVATV
CASSEIGGGNTGELFF	other
CASSLAGVSYEQYF	NLVPMVATV
CASSQEGWETQYF	NLVPMVATV
CSAVPVSGVDEQFF	other
CASNPQGSSYNEQFF	NLVPMVATV
CASSLESDTQYF	other
CASSILAGGYNEQFF	other
CASSILNVSWTGSNQPQHF	NLVPMVATV
CAATSGEASGQPQHF	other
CSTRDRGLLNTEAFF	other
CASGKQENEAFF	NLVPMVATV
CASSRERVGETQYF	NLVPMVATV
CAINAGDTGELFF	NLVPMVATV
CASSWGAAGYEQYF	other
CAWSLSSGELFF	other
CASSLRSQETQYF	other
CASTRDSYQPQHF	NLVPMVATV
CASSRDPSSGANVLTF	NLVPMVATV
CSVTHGGGNQPQHF	other
CSARGPSGANVLTF	other
CASSPVSTDTQYF	other
CAWSLLNDLEAFF	other
CATSVGTEETHYGYTF	other
CSARVSSASGTYEQYF	NLVPMVATV
CATSAAGRSEQFF	NLVPMVATV
CATSRDRAFF	NLVPMVATV
CASSYTNEQFF	other
CASRTSVDTDTQYF	NLVPMVATV
CASSPRAGQPQHF	other
CSARGPSGELETQYF	NLVPMVATV
CASSLMYEQYF	other
CASSPRTIYTYEQYF	NLVPMVATV
CASSFPGYSYEQYF	NLVPMVATV
CASSLVAGSYEQYF	other
CSARGADFSFF	NLVPMVATV
CASSYGTSGMETQYF	NLVPMVATV
CASIKDRRDERTEAFF	other
CASSFYGAGGEQYF	NLVPMVATV
CASSLGPAYEQYF	NLVPMVATV
CASSQARGEQYF	NLVPMVATV
CASSPRDGQETQYF	NLVPMVATV
CASSRTSGISLTDTQYF	other
CASSPDRGPPLHF	NLVPMVATV
CASSLVNEQFF	NLVPMVATV
CACPGPLTYEQYF	other
CASGTGGNYNEQFF	NLVPMVATV
CASSPGGADPSDF	NLVPMVATV
CASETERVRGGYTF	NLVPMVATV
CASTSEGGGGTEAFF	NLVPMVATV
CASTLAGGLPEQFF	other
CSALPFYGYTF	other
CASRSRVEQNTGELFF	other
CASSPGPGELFF	other
CSVPKTGSYEQYF	other
CATSRSGQGYTLGQPQHF	NLVPMVATV
CSVDTDGLSGANVLTF	NLVPMVATV
CASSLAGGRDEQFF	NLVPMVATV
CASSLTGPTTTETQYF	NLVPMVATV
CACQELNTGELFF	other
CASSFEGIYEQYF	NLVPMVATV
CASSFRDRGLNEQFF	NLVPMVATV
CASNAGNRRSSPLHF	other
CSVATGRGELFF	NLVPMVATV
CAWSWGTPENIQYF	NLVPMVATV
CASSVGQDGYTF	NLVPMVATV
CASSQDLKETQYF	NLVPMVATV
CASRQGDSYNSPLHF	NLVPMVATV
CASSLGQGSNQPQHF	NLVPMVATV
CASSIHHGNEQFF	other
CASSLEGAPTDTQYF	NLVPMVATV
CASRLQVGTEAFF	other
CATSRSLGGAYEQYF	NLVPMVATV
CASSLFGIGNQPQHF	other
CASSWAQDRGPTGELFF	other
CASSRGQGNTEAFF	NLVPMVATV
CASSQASPGDEQFF	other
CASSIFDGYYEQYF	other
CASSGQGAQPQHF	other
CASSGRSLEEQYF	other
CSATGVGYNEQFF	other
CAWSVLTAESGELFF	NLVPMVATV
CASSLRVTEAFF	NLVPMVATV
CASSQSGIKDTQYF	NLVPMVATV
CASSHGTGGYEQYF	NLVPMVATV
CAWSSGRENYGYTF	NLVPMVATV
CASSLAGGINEQFF	NLVPMVATV
CASSPLPGGETQYF	other
CASRDGGQIDESQYF	NLVPMVATV
CAIGDRNTGELFF	other
CASSLSGAGNEQFF	other
CASSIVSSSYNEQFF	other
CASSLVSQGGYEQYF	other
CASTKGGRPEAFF	other
CASSAGSGASYEQYF	other
CSAGQRNTGELFF	other
CASSLLPYEQYF	NLVPMVATV
CATSARGQPQHF	other
CASIQVARGEGQENYGYTF	other
CASSLAYKRQGPSMGTEAFF	other
CASSPSYNEQFF	NLVPMVATV
CASSYQSGNTEAFF	other
CASSATSGGADTQYF	other
CATSVPRGEQYF	NLVPMVATV
CASSDGTGGSPLHF	NLVPMVATV
CASTLTVAGWTEAFF	NLVPMVATV
CASRTEGAGWTEAFF	NLVPMVATV
CASTAGQGDYEQYF	NLVPMVATV
CASSRGQESPYYGYTF	other
CASSLDGGTAYEQYF	NLVPMVATV
CASSIQGSSYEQYF	NLVPMVATV
CASSFPDPPDTQYF	other
CSARTRTGLPNYGYTF	NLVPMVATV
CASSYGYGEKLFF	NLVPMVATV
CAWSIIQGAPMYGYTF	NLVPMVATV
CASSPGTAFEETQYF	NLVPMVATV
CASSSVSEAFF	NLVPMVATV
CASSQLFGEDTQYF	other
CASSLNYEQYF	NLVPMVATV
CASSWDPAGTYNEQFF	NLVPMVATV
CASNMLSTDTQYF	other
CSVGASYYEQYF	other
CASSLGVWDSALSQALHF	NLVPMVATV
CASGTHFSPYNEQFF	NLVPMVATV
CASSGYNEQFF	NLVPMVATV
CASSESVSSYNEQFF	NLVPMVATV
CSVHTGHEQFF	NLVPMVATV
CASSQFDGVNEKLFF	NLVPMVATV
CASSRGGGSNQPQHF	other
CASMDQNTGELFF	other
CASSQAGSSYNEQFF	NLVPMVATV
CASSPSSAIYEQYF	NLVPMVATV
CASSYGLAVTDTQYF	NLVPMVATV
CASYQGAMNTEAFF	NLVPMVATV
CASSLDEGALFTEAFF	NLVPMVATV
CASSVGIYGYTF	other
CASSPWEAGGAYEQYF	NLVPMVATV
CAWSPTGMGTEAFF	other
CASSLQGLESSSTDTQYF	NLVPMVATV
CASSYSTDTQYF	NLVPMVATV
CASSLNSLYGYTF	NLVPMVATV
CASSLSTGQGGEAFF	NLVPMVATV
CASSSSAPTPDTQYF	other
CASSLPGMSNSPLHF	other
CASSKEPRVGAPEKLFF	NLVPMVATV
CSAGDREPYEQYF	NLVPMVATV
CASSQDVGAGANVLTF	other
CASSQGTGEAYEQYF	other
CSVGPGTLANTEAFF	NLVPMVATV
CASSLGLNYEQYF	other
CSARLAGTYEQYF	NLVPMVATV
CASSPRTFNEQFF	NLVPMVATV
CAWSVRGHNTGELFF	NLVPMVATV
CASSFSGDEQFF	other
CASSPEGRTDSPHTDTQYF	NLVPMVATV
CASRSWTGEADTQYF	NLVPMVATV
CASSSVTIAGGRIQYF	other
CASSSTGEGGNYEQYF	other
CASTPGPQVDTQYF	other
CSVAGGANYGYTF	NLVPMVATV
CSVGQTSSYEQYF	other
CSARDERAVNTGELFF	other
CASSLGGGAGNEQFF	NLVPMVATV
CASSALLAGGPHYEQYF	NLVPMVATV
CASSFSTGTAGGYTF	NLVPMVATV
CSADSWAGGGYEQYF	other
CASSSRLSDFGTDTQYF	other
CSARASRTFTDTQYF	other
CASSPPGGLVAFF	other
CAGGDRDTGELFF	NLVPMVATV
CASSEFGTSGSGEQFF	other
CAIASGTVRGNTIYF	NLVPMVATV
CASSVGELAGGLDTQYF	other
CASSITGWGSPLHF	other
CAISGVTGTPDTQYF	other
CSVGTATNEKLFF	other
CSSSIRSSYEQYF	other
CASSLWDGREEKETQYF	other
CASSEYFVGQGASYGYTF	NLVPMVATV
CASSPGTVNTDTQYF	NLVPMVATV
CASSLGRNYGYTF	NLVPMVATV
CASSVDWDRVSGNTIYF	NLVPMVATV
CATSSGGTEAFF	other
CASSMGLYNEQFF	other
CASSSPYRRSYNEQFF	other
CASGQTYEQYF	other
CASSVVSTDTQYF	other
CASSYGEGLSEQYF	NLVPMVATV
CASSQGPGQGDYEQYF	NLVPMVATV
CASSLSVGLVETQYF	NLVPMVATV
CASSQDLLAGNEQFF	other
CASSTGQVDTGELFF	other
CASSPRLRGEGLNEQFF	other
CASSQTQGNEQFF	other
CASSRELTGTDSYEQYF	other
CASSQLLADPPDEQFF	NLVPMVATV
CASSRGFGLRAGQRNQPQHF	other
CASSRAGQLNTEAFF	NLVPMVATV
CASRGTSGGPNTGELFF	NLVPMVATV
CASSIDHSTYYEQYF	other
CSARDGWDHNTGELFF	other
CASSLAPGATNKKLFF	NLVPMVATV
CSVPTGLGYTF	other
CASSQVGYRTYEQYF	NLVPMVATV
CSAVLDRGTGESYEQYF	NLVPMVATV
CATSRDRGHTDTQYF	NLVPMVATV
CASSRGTGPFSYEQYF	NLVPMVATV
CASSPGQGNQPQHF	other
CSAREQRGYNEQFF	NLVPMVATV
CSAGTANYGYTF	NLVPMVATV
CASSQTSGGYNEQFF	NLVPMVATV
CASSLHRGTEAFF	other
CASSQQGEKLFF	other
CASSWTSGMYEQYF	other
CASRFSGTPDTQYF	other
CASSAQGVSGANVLTF	other
CASSFQGVGQPQHF	other
CASSVPDRANTGELFF	other
CSARELGEEAYEQYF	other
CASSPRAGEGTEAFF	NLVPMVATV
CASSQVRKGQGAGNQPQHF	other
CASSRGAFYNEQFF	other
CATSDDLQETQYF	other
CASTFGGPNSPLHF	other
CASSQGTEHSNQPQHF	other
CASSVASGQGYEQYF	NLVPMVATV
CASSLTSGDRGRWNIQYF	NLVPMVATV
CASSIGHNTGELFF	other
CASTRDSYSGNTIYF	other
CASSLNSPIAYGYTF	other
CAISDRDAYYEQYF	NLVPMVATV
CASSQDGGTSGADTQYF	other
CATILYEILLGKATLYAVLVSALEQYF	other
CSAIDFPMGNEQFF	other
CASSLEQGNNEQFF	NLVPMVATV
CASSGRRQGGNGYTF	NLVPMVATV
CASSLGDTEAFF	NLVPMVATV
CASSLRASETQYF	other
CSAQGTETNYGYTF	other
CASSPEESSYNEQFF	NLVPMVATV
CASSPGTDMNTEAFF	NLVPMVATV
CASSLNVPRSGYEQYF	NLVPMVATV
CASSHEQGRNYGYTF	NLVPMVATV
CASSQDLAGGPDTQYF	other
CASSYLAGVYNEQFF	NLVPMVATV
CASSVGLAGSGYEQYF	NLVPMVATV
CASSPPNSYEQYF	NLVPMVATV
CATSRRDQYNEQFF	other
CASSPGDRRYSPLHF	other
CASSDPGQGVQTYEQYF	other
CASSLSLGWETQYF	NLVPMVATV
CATSDTHSGANVLTF	other
CASSLGETQYF	other
CASSQAPTSGNEQFF	NLVPMVATV
CASNRGAEPQHF	NLVPMVATV
CSVEDWGIEATDTQYF	other
CASSRLSTDTQYF	other
CSARVGESSYNEQFF	NLVPMVATV
CASSLAGQGDNYEQYF	other
CASSFVPSEAGGNVNEQFF	other
CASSLWVENYGYTF	NLVPMVATV
CASSLRSTGTQYF	other
CASSPWAVGAMNTEAFF	other
CALGEPNTGELFF	other
CASSIHQGLAEAFF	NLVPMVATV
CASSFVDRDTEAFF	other
CSASRTDYVYTF	NLVPMVATV
CASSFPGSGGLDEQFF	NLVPMVATV
CASSLGGNEQFF	NLVPMVATV
CASSVSGSSYEQYF	other
CASSWGLLSNQPQFRG	other
CASSAVRGELFF	other
CASSLLAGANEQYF	NLVPMVATV
CATSRPVEGPYSYTF	NLVPMVATV
CATSRKQGNTEAFF	other
CASSYGGLGQPQHF	other
CASSLAGSSYEQYF	other
CASSRLPTGSQTDTQYF	NLVPMVATV
CASSGQRSGNTIYF	other
CASSQEQGGDEQFF	NLVPMVATV
CASSPTPGQGVTGELFF	other
CASSLDTGGRLNEQFF	NLVPMVATV
CASSYMGLPNSPLHF	NLVPMVATV
CASSMRAAETQYF	NLVPMVATV
CASSVGSPDTQYF	NLVPMVATV
CASSLSRNQPQHF	NLVPMVATV
CASIANRNTGELFF	other
CASRPEGGSNYGYTF	NLVPMVATV
CASTSRLRTGTEETQYF	other
CATIEARGSGELFF	other
CASNLGGGTGELFF	NLVPMVATV
CSARTGEGSPLHF	NLVPMVATV
CASSTPRKEWGRAEAFF	other
CASSPTGLVDEQFF	NLVPMVATV
CASSMRHLEEQYF	other
CSARDPGHLNTIYF	NLVPMVATV
CASSVGLDSAREAQHF	other
CASSLLGQAYGYTF	other
CASSYGTGGQETQYF	other
CASSSPSGALSGELFF	NLVPMVATV
CASSPRSGIEQFF	other
CASSYSEGTEAFF	NLVPMVATV
CANSQAGMAEQFF	NLVPMVATV
CASSQDLGLLRDTGELFF	other
CASSKEFGQGQCGNQPQHF	other
CASSYSEVYGYTF	NLVPMVATV
CASSLNIEQAVDEKLFF	NLVPMVATV
CATSRVPTGADNEQFF	NLVPMVATV
CASSQEALTGAKNIQYF	NLVPMVATV
CATSGRPGSSYEQYF	NLVPMVATV
CASSPGTGWAEAFF	other
CASSRQGLETQYF	other
CASSFGGEQFF	NLVPMVATV
CSARGGQVDTEAFF	NLVPMVATV
CASGLAGEQYF	other
CASKGALEGYTF	NLVPMVATV
CSAIYSPLMAEAFF	other
CASSLLAGGSGTDTQYF	other
CASKQGAEAFF	NLVPMVATV
CSVREDSTNEKLFF	other
CASSFMGADYGYTF	other
CASSMTSTDTQYF	other
CSAGTGDSTDTQYF	NLVPMVATV
CASSDPWAGTDTQYF	NLVPMVATV
CASSLFSIGEQFF	other
CASSTHHLGIQYF	other
CASSELPSAGGNLHF	NLVPMVATV
CSARGFTSGDSETQYF	other
CASSPWSGSQETQYF	other
CASSILAGAADTQYF	other
CASSFGGSNQPQHF	NLVPMVATV
CSVYPSGDYNEQFF	NLVPMVATV
CASSSPPGGASDTQYF	NLVPMVATV
CSANSRTGLGYTF	other
CASRSGAEALF	other
CSAPRLAGPYEQYF	NLVPMVATV
CATSDFVGGTEAFF	NLVPMVATV
CSARTQGDTGELFF	NLVPMVATV
CASSLTGLEAFF	NLVPMVATV
CATRTGAYEQYF	NLVPMVATV
CASSDQETQYF	other
CASSFLWANQGATNTGELFF	NLVPMVATV
CASRDTGQRQPQHF	other
CASRKGGSSYNEQFF	NLVPMVATV
CASRDGGQIDKTQYF	NLVPMVATV
CASSHTRTLGAKNIQYF	other
CASSEGPMNTEAFF	other
CASSAPPGTQYF	other
CTSSPVAGAPHEQYF	NLVPMVATV
CSARDDTTDTQYF	other
CASRLRESSYEQYF	NLVPMVATV
CASSIGVGEAFF	other
CASSIRTAETQYF	NLVPMVATV
CATSEGTAVSGNTIYF	other
CASSAIAGGNYEQYF	other
CASSPQTDTQYF	NLVPMVATV
CASSAGTGEETQYF	NLVPMVATV
CASGLTGFMDEQYF	NLVPMVATV
CASSNRETDTQYF	NLVPMVATV
CATSDGQGGYNEQFF	NLVPMVATV
CASSSRAGWELFF	other
CASSLELAVTDTQYF	other
CASSLQGFAEQYF	NLVPMVATV
CASSLGASGSAGELFF	NLVPMVATV
CASRTTYGYTF	NLVPMVATV
CSVEQGAIGYTF	other
CASAETGQGAAGYTF	NLVPMVATV
CATSEVGTPNEQFF	NLVPMVATV
CASSVAPDTQYF	other
CASTPGTGALTDTQYF	NLVPMVATV
CASSPPTGAGAGISYTF	other
CSVQQGNTGELFF	other
CSAHGDLNTGELFF	other
CASRDSLNEKLFF	NLVPMVATV
CASSDTGVYNEQFF	NLVPMVATV
CASSFLQGLNTEAFF	other
CASSQYMTTNTEAFF	other
CASSDSSGYSGANVLTF	NLVPMVATV
CSARDGDRATNNSPLHF	NLVPMVATV
CASSLLQGALSSTDTQYF	other
CASSRGGAYNEQFF	NLVPMVATV
CASSTRGESTDTQYF	NLVPMVATV
CASSLGGQNSPLHF	NLVPMVATV
CASSPLSEKLFF	other
CRAGGLAGALSYF	other
CASSLKGTGELFF	NLVPMVATV
CASSLSGVTEAFF	other
CASSRLAGGNNEQFF	NLVPMVATV
CASSFLGAGTEAFF	NLVPMVATV
CASSPGGGGYQPQHF	NLVPMVATV
CASTLGGESNQPQHF	NLVPMVATV
CSATTRSSQYF	other
CASSIYIWTEAFF	other
CASSPSSLDGTGQFF	other
CPSSLAPGATNEKLFF	NLVPMVATV
CASSEFEGVNTEAFF	NLVPMVATV
CASRSGQGNQPQHF	NLVPMVATV
CASSPDRGDPYEQYF	NLVPMVATV
CASSFVLAGGGYF	other
CAWSGGVRDNEQFF	NLVPMVATV
CASSYSGTNEQFF	NLVPMVATV
CASSKTSGGYNEQFF	NLVPMVATV
CSASPASGEETQYF	other
CASSMRSSGTQYF	other
CASSQVQGWTEAFF	NLVPMVATV
CSVVSLAEQETQYF	NLVPMVATV
CASSLPGTGHGNEQFF	NLVPMVATV
CASSQETTSEQYF	other
CASSLGTNGYNEQFF	NLVPMVATV
CATQGWDTGELFF	other
CSVQGGTYNEQFF	NLVPMVATV
CAWAGPGGLREQFF	NLVPMVATV
CASSPPGPLKADTQYF	NLVPMVATV
CASRTVNSPLHF	other
CASTGQGFYEQYF	NLVPMVATV
CASSFIDLSGAGGYTF	NLVPMVATV
CASSQVNIRGNEQYF	other
CASNHANTGELFF	other
CASSFPGALNIQYF	NLVPMVATV
CASTPSFEQYF	other
CASSIRGSDEQYF	other
CASSLRQYEQYF	NLVPMVATV
CASQQGEVTEAFF	other
CASSLPPFASTSTDTQYF	NLVPMVATV
CASLEEDTGELFF	other
CASSTGQGFTEAFF	other
CASSLGQISGNTIYF	other
CASSLTGAQETQYF	other
CASSLERGGKLFF	other
CATSRPGDGETQYF	other
CSVDRGLNTEAFF	other
CASSLPGGGTNTGELFF	NLVPMVATV
CASSIYSKETQYF	other
CASSVFLLGTGELFF	NLVPMVATV
CASSPYAGANTEAFF	other
CASSDRANTEAFF	other
CSARTGRFYEQYF	NLVPMVATV
CASSFGLHGYTF	other
CASSPLATGAYGYTF	NLVPMVATV
CSVGSGGTNEKLFF	other
CASSSGQPNTGELFF	other
CASSPGISVNYGYTF	other
CASSWSASYEQYF	other
CASSTGQGASNEKLFF	other
CASSIISGPYNEQFF	other
CASTHLRDKTFF	other
CASSIGWSGYTF	other
CASSSGNTEAFF	other
CASGDSSMRYTF	other
CASIGGGGWAQPQHF	other
CASSFAGLNYGYTF	NLVPMVATV
CASSSRTGWDSPLHF	NLVPMVATV
CASSPSEETNYGYTF	NLVPMVATV
CASSVLRGRQGAWGEKLFF	other
CASSYGGGTYEQYF	NLVPMVATV
CASSLLHLSPGEQYF	other
CASQIALQGEAFF	NLVPMVATV
CASSLSLTSGGAGTDTQYF	other
CSAVAVYNEQFF	NLVPMVATV
CASRAGNQPQHF	other
CASSQGLTSEQFF	NLVPMVATV
CASSYSGTWAGNQPQHF	other
CASSPKDTPYEQYF	other
CSASAADTDTQYF	other
CASSSLGSDTQYF	other
CASSLEVAGGNEQFF	other
CASSPPGAANYGYTF	NLVPMVATV
CASSLGGAETQYF	other
CASSDNYGYTF	NLVPMVATV
CSARDGIESNEQFF	NLVPMVATV
CASSPGGLEAFF	other
CASSLGMGLMAFF	other
CASSYYSGGGSAFF	NLVPMVATV
CAWSSQTGIYGYTF	NLVPMVATV
CASSSPGTGGGVYGYTF	other
CSATPRDSNYEQYF	NLVPMVATV
CASQGLNTGELFF	other
CASSYNTEAFF	NLVPMVATV
CSARGRGIGTGELFF	NLVPMVATV
CASSASGGANVLTF	other
CASSMGRTQYF	NLVPMVATV
CASSLAIGSDSYEQYF	NLVPMVATV
CASLKGGGTEAFF	other
CSAEGNTEAFF	other
CASSIYHTDTQYF	other
CSADTGAPSYGYTF	NLVPMVATV
CASSLQGLGYTF	NLVPMVATV
CASSIVGSAYNEQFF	other
CASSGQSNQPQHF	other
CASSGRASGELFF	other
CASQSYRVGSEQYF	other
CAIQDLNTGELFF	other
CASKGMASGGLRGTGELFF	other
CASSVVSTTEAFF	other
CASSLDLGREPRETQYF	NLVPMVATV
CATSPRTNYGYTF	other
CASSIRASQPQHF	other
CANSVRRGELFF	other
CASSSVGEWHF	NLVPMVATV
CASSSPGASTYEQYF	other
CASSISGTEQFF	NLVPMVATV
CASRGLAGVSYEQYF	NLVPMVATV
CASNQVTGTGAYSYTF	NLVPMVATV
CASSQALGPPVPAFF	NLVPMVATV
CASSEPPRRGGPNEKLFF	NLVPMVATV
CAISESSEQFF	other
CASTIGLARGAGTGELFF	other
CASSFGHSEAFF	NLVPMVATV
CASSDDIEAFF	other
CSARDHRHSNQPQHF	other
CASSPRGWNTGELFF	NLVPMVATV
CASSLSARRDMEETQYF	other
CASSPPDPQETQYF	NLVPMVATV
CASSEARGLAEFTDTQYF	other
CASSIFGSDYNEQFF	other
CASSPDFGSYNEQFF	NLVPMVATV
CAISKSKGYEQYF	NLVPMVATV
CASSFGGTQYF	other
CASSLSSSTGPTDTQYF	other
CASSLFGGTDTQYF	other
CASSLIAGGHTGELFF	NLVPMVATV
CASSGINNEQFF	NLVPMVATV
CASSLGYEQYF	other
CSARGTGTGSEQYF	NLVPMVATV
CASSPGLGPGAFF	other
CSARDTASAYNEQFF	NLVPMVATV
CASSPSPSGDDEKLFF	NLVPMVATV
CASSGGTGGNEQFF	other
CALFRDRNTGELFF	other
CASSVRSSYKQYF	other
CASRSGTEAFF	other
CASSPVGEGVLYGYTF	other
CASSPTGGTGNEQFF	NLVPMVATV
CASSLSLVGPHQPQHF	NLVPMVATV
CASSSTSSGANVLTF	NLVPMVATV
CAISEDGGETQYF	other
CASSSPGTGTYNEQFF	NLVPMVATV
CASSSSLAGGREQYF	other
CAWSEVHEQFF	NLVPMVATV
CASSEEYNEQFF	other
CASSRSLNVNSNQPQHF	other
CASASGANTGELFF	other
CASSGTGWEETQYF	NLVPMVATV
CASSFGQGAFF	NLVPMVATV
CASSYPRDAGTSLDIQYF	other
CASGREEGNEQFF	other
CASSYSEGTKAFF	NLVPMVATV
CSARDLVRYEQYF	NLVPMVATV
CSVETSGGVGEQFF	NLVPMVATV
CASNTGTTQETQYF	other
CASSILGGADVQFF	other
CASSLRSTVEQFF	other
CASSQSLRGFYEQYF	NLVPMVATV
CASSPDSEQYF	other
CASSPRAGNEKLFF	other
CASQDLNTGELFF	other
CASSLAPGAINEKLFF	NLVPMVATV
CSARTGGMFYNEQFF	other
CSAPARVSYEQYF	NLVPMVATV
CASRREGRVNEKLFF	other
CATSRSTGDEQFF	other
CASSLEYREADTQYF	NLVPMVATV
CASSLGRGWAPLHF	other
CASSLWGGPQGTF	other
CASSFDLAETQYF	NLVPMVATV
CASSYSTGVGSPLHF	NLVPMVATV
CASSASTGGGYTF	other
CASSLSIAGTNTGELFF	NLVPMVATV
CSAELGMGQPQHF	other
CASSSVSGFHEQYF	NLVPMVATV
CASWLNTEAFF	NLVPMVATV
CASSLLFWTGNGSYNEQFF	NLVPMVATV
CASSFIRGRDSPLHF	NLVPMVATV
CASRPLLGSNQPQHF	other
CASSGEDRVVYGYTF	NLVPMVATV
CSARGTNNNEQFF	other
CASSNSYGYTF	other
CASSARGAYEQYF	other
CSARESPLARSYEQYF	NLVPMVATV
CASSIIAGMDEQFF	other
CASSLTGGGNIQYF	other
CASLSRRRRQYF	other
CSVGSLGGVGKNIQYF	NLVPMVATV
CASSILTGQEQFF	other
CASSQRSSDTQYF	other
CASRPTANYGYTF	NLVPMVATV
CSARDRKFDSSYEQYF	other
CASSIFGGPKPQHF	other
CASSYSPGGSLSYNEQFF	NLVPMVATV
CASSEVVTAFSYEQYF	other
CASPPDLASTDTQYF	NLVPMVATV
CASSRYSNQPQHF	NLVPMVATV
CASSIVVQGNEQFF	other
CASSVDGNEQFF	NLVPMVATV
CVSSQAGMAEQFF	NLVPMVATV
CASSLERYEQYF	NLVPMVATV
CSAPVPGQGLNTEAFF	other
CASTRDIEAFF	other
CASSLASEKLFF	other
CSARSPLTEGSSGNTIYF	NLVPMVATV
CASSLEGSHLGAFF	NLVPMVATV
CASSVYGANNEQFF	NLVPMVATV
CASSPPLAGPSTDTQYF	other
CASSSQQESIFTGELFF	NLVPMVATV
CASSFGGDEAFF	NLVPMVATV
CASSIGIGEAFF	other
CASSQAAGVGYPTEAFF	other
CASSTGPEQFF	NLVPMVATV
CASSQVGSAPLDEQFF	NLVPMVATV
CASSLLATDTQYF	other
CASSPDRAEGDTQYF	other
CASTLGQTLTGELFF	other
CASSYVGPESTDTQYF	other
CASSLTSGGANEQFF	NLVPMVATV
CASSPGGIAFF	other
CASSSTGGTNTEAFF	other
CASSVTGHPNTEAFF	NLVPMVATV
CAWTSGRGAEQYF	NLVPMVATV
CASTRGQGAGGNTIYF	other
CASGQGNTEAFF	NLVPMVATV
CASSWTKSAGEQYF	NLVPMVATV
CASSTPGQGTQPQHF	other
CASSLGGYTF	NLVPMVATV
CASSHTLGGKQYF	NLVPMVATV
CASSVASGGFSDTQYF	NLVPMVATV
CASSVGGVSYNEQFF	NLVPMVATV
CASSSIFPGELFF	other
CASSPIAGGPYEQYF	other
CASSQGRGGKNIQYF	NLVPMVATV
CASSSPVAEYNSPLHF	NLVPMVATV
CSVMGTINEQFF	NLVPMVATV
CATSRDRSGAGGGYNEQFF	NLVPMVATV
CASSDSGELFF	NLVPMVATV
CASSLGQGIYGYTF	NLVPMVATV
CASSPTGGSYNEQFF	other
CASSIEGQGAYEQYF	NLVPMVATV
CAWSSGGLATNEKLFF	other
CSVESAGGYGYTF	NLVPMVATV
CASSNRASNEQFF	other
CASSSQPAETQYF	NLVPMVATV
CASSQDHGSGELFF	other
CASSIGGPDTQYF	other
CSAREGGASGSPFSYEQYF	other
CASSLAGLAGRTYEQYF	NLVPMVATV
CAWSVGGQPQHF	other
CASSDAGGTGNEQFF	NLVPMVATV
CASSLGTDTQYF	NLVPMVATV
CASSIGRTYEQYF	NLVPMVATV
CATKRGAFDYGYTF	other
CASSLVVREQFF	NLVPMVATV
CASSIGGNQPQHF	other
CASSYDGSREKLFF	other
CASSIRSGEEQYF	other
CATSDLRGDYNEQFF	other
CASSFYFTRAPYNEQFF	NLVPMVATV
CASSSVDEQFF	NLVPMVATV
CASSTGLAYEQFF	other
CATSGRSLEEQYF	other
CASSQLGQYTDTQYF	NLVPMVATV
CAWSVMGATNEKLFF	other
CATSDFGDGGYEQFF	NLVPMVATV
CASSPDRESNQPQHF	other
CASSVEDRANTEAFF	NLVPMVATV
CASSQYSNQPQHF	other
CASSILAVDEQFF	other
CALSVWGLNYGYTF	other
CASSRTPTAQQEETQYF	NLVPMVATV
CASRKTGNTEAFF	NLVPMVATV
CASSVADGNPQHF	other
CASSPPTSGTANEQFF	other
CASSYLGQGNEQFF	other
CASNSGNTIYF	NLVPMVATV
CSARDHQGSSTSPLHF	NLVPMVATV
CASSPVARAPHEQYF	NLVPMVATV
CSVGLRQGNTEAFF	NLVPMVATV
CASSRPGHPYEQYF	NLVPMVATV
CSVADYSGLVPSTDTQYF	other
CASSQTAGAQGYYGYTF	NLVPMVATV
CATSRGWIAGFEQFF	other
CASSLPQGRYMNTEAFF	other
CASSSDRSSSGANVLTF	other
CASSLVGAWPQHF	NLVPMVATV
CASSTPNYLREDTEAFF	other
CSGKRDTSWTDTQYF	NLVPMVATV
CASSPREGANAYEQYF	NLVPMVATV
CASSQEGTGLMNTEAFF	other
CASSQSGAEAFF	other
CASSPPGLEWGYTF	NLVPMVATV
CASSQVGQVKLWPKVPQFF	other
CASSEEVLQETQYF	NLVPMVATV
CASSLGGEAFF	NLVPMVATV
CASSPRSGQPQHF	other
CASSFHDRGDQPQHF	other
CASSGVGGWDEQYF	NLVPMVATV
CASSLAGFGNTIYF	other
CASSLAPSTEQYF	other
CASSPAYEQYF	NLVPMVATV
CASSPEQGPLEAFF	other
CASSFGLIEVPGNTIYF	other
CASRTGSMNTEAFF	other
CASSLSSGTGTYEQYF	NLVPMVATV
CASSEQGANEKLFF	other
CSVELGENIQYF	NLVPMVATV
CASSSAFDNYEQYF	NLVPMVATV
CASSSVGEAFF	NLVPMVATV
CASSQGRGSGNTIYF	NLVPMVATV
CASSLSASGYNEQFF	NLVPMVATV
CAWVPTGTGGTEAFF	NLVPMVATV
CASSDSVGTGANVLTF	other
CASSPYTGNEQFF	NLVPMVATV
CSVVAGRTEAFF	other
CASSFWELNTEAFF	other
CASSSPVQTSGLHEQFF	other
CASGYSPLHF	other
CAWRLNNEQFF	NLVPMVATV
CASSQDVNPRASLGYEQYF	NLVPMVATV
CASSTGGSKNIQYF	NLVPMVATV
CASSQDRLFVGPKNTEAFF	other
CASTGGLGYTF	other
CASSSTGNYGYTF	NLVPMVATV
CAWSETLNTEAFF	NLVPMVATV
CSASGTGGVETQYF	other
CASSPRFGTNQPQHF	other
CASSLEFGQGASSYEQYF	NLVPMVATV
CASSLVPSGPGELFF	NLVPMVATV
CASAPPQHF	other
CSARGWGNEANTGELFF	other
CASSLGTSGIYEQYF	NLVPMVATV
CASSSRDRPMGPQHF	NLVPMVATV
CASSKNRDSVAKNIQYF	NLVPMVATV
CASSVSSDTDTQYF	NLVPMVATV
CASSLAPRATNEKLFF	NLVPMVATV
CASSLVSSTEAFF	NLVPMVATV
CASSSLSTGGTYEQYF	other
CASSLQRGKVYEQYF	other
CASSVAIWRGSYNEQFF	other
CASSFGAGAGSYNEQFF	other
CASSLGTGSAEPQHF	NLVPMVATV
CASSIDVGELFF	NLVPMVATV
CASSVEGARFGYTF	NLVPMVATV
CASSIRAAETRYF	NLVPMVATV
CSVGFNQPQHF	NLVPMVATV
CASSLEASGSSYNEQFF	NLVPMVATV
CASSQEPGLAAYEQYF	NLVPMVATV
CASSQEAQGLGEKLFF	other
CASSYTDSTDTQYF	other
CASSVEGGSGELFF	NLVPMVATV
CSARDRLAGDTDTQYF	NLVPMVATV
CASSLEGTATDTQYF	other
CASSVLDTQYF	NLVPMVATV
CASSYPDRGTSTDTQYF	other
CAWSGDSLDTIYF	NLVPMVATV
CASSWETGGTGYTF	NLVPMVATV
CASSYSGSGANVLTF	other
CASSLTYGQYF	NLVPMVATV
CASSLGAGASDEQYF	other
CASSAGGLAGDEQYF	NLVPMVATV
CASSLAAGNEQFF	NLVPMVATV
CASSYSGSNEQYF	other
CSANSSPLHF	other
CATSPLLESNYGYTF	other
CARRSWGASEQFF	other
CASSRTGTGGVEPQHF	other
CATSGDFGNTIYF	other
CASTLEGSSGYGYTF	other
CSVVPEGGSYEQYF	NLVPMVATV
CSARDHGQEYNEQFF	NLVPMVATV
CASSPPGAGNTGELFF	other
CASSIAGSAYEQYF	other
CASSFAPGTANTGELFF	NLVPMVATV
CASSFFVGAGVGGTQYF	NLVPMVATV
CASSLLLARETQYF	other
CASSLGRVDEQYF	NLVPMVATV
CASSLLVISHQPQHF	other
CASSYTGGLMAFF	other
CAVQDSNTGELFF	other
CASSQEEVTGDKPYEQYF	other
CASRELGLAKNIQYF	other
CASSYKGAQETQYF	other
CASSPGQSLIYEQYF	NLVPMVATV
CAWTDNTGELFF	NLVPMVATV
CSVADGGPYGYTF	NLVPMVATV
CASSIGKSWELFF	NLVPMVATV
CATTERDQETQYF	other
CASSRLLGQRQETQYF	NLVPMVATV
CASASISNQPQHF	other
CASSIRPSYEQYF	other
CASRTKTVNTEAFF	other
CASSYGNPNTGELFF	NLVPMVATV
CASSIRSSWELFF	other
CASSVTAGRPFLLYNSPLHF	NLVPMVATV
CASSQEAGGEQYF	NLVPMVATV
CASTRSADTQYF	NLVPMVATV
CSARGQGTGELFF	NLVPMVATV
CASSYSGQGTDTQYF	NLVPMVATV
CASSLFAGTYEQYF	NLVPMVATV
CASSIQRNYGYTF	other
CASSLEGAGGPFDIQYF	NLVPMVATV
CAWSALLPGQGEKNTEAFF	other
CASSIFYTSGNTIYF	other
CSAQAGVDNSPLHF	other
CASSLDTGTALSYEQYF	NLVPMVATV
CASSYSGRSYEQYF	NLVPMVATV
CASSIVPISYNEQFF	NLVPMVATV
CASSLTELPYGYTF	NLVPMVATV
CASSERGGAGYGYTF	NLVPMVATV
CASSLEEGGGAYEQYF	other
CASSYGQLSNQPQHF	other
CAISGSNRTGLMLISPLHF	other
CASSIYSGSYNEQFF	other
CASSILGSGEQFF	NLVPMVATV
CASSQAQLTTSSYEQYF	NLVPMVATV
CATSRDPGGSTDTQYF	other
CASSMLALGPQHF	other
CASSSLETQYF	other
CASSRQGPDGYTF	other
CASSPFGTSGSYNEQFF	NLVPMVATV
CATSRTSGRPSTDTQYF	NLVPMVATV
CASRVLPRLAETPLSTDTQYF	NLVPMVATV
CSARVGYEQYF	NLVPMVATV
CASSPGLIRITGELFF	NLVPMVATV
CASSQDLGTDTQYF	other
CASSPSWDLQETQYF	other
CASSQDNGYEQYF	other
CASSIRADGELFF	other
CASSVGTSSYEQYF	other
CASSQASGGYTGELFF	NLVPMVATV
CASSNTGTSGGYEQFF	other
CASSAAGGTGSGELFF	other
CASSYRKSTDGQGLFF	NLVPMVATV
CASSYGRQGIMNTEAFF	other
CASSALSGSWGQPQHF	NLVPMVATV
CSLRDGRNNEQFF	NLVPMVATV
CASSLGGSYGYTF	other
CASSPTSIANTGELFF	other
CASSLVPRAYEQYF	NLVPMVATV
CASSYGSYGYTF	other
CDSSQTQLWETQYF	NLVPMVATV
CASSHGTSGYTF	NLVPMVATV
CASSIAGSKTQYF	NLVPMVATV
CATWTENMNTEAFF	other
CSAVSDTQYF	other
CASSSRDRGGEGTDTQYF	other
CSVAGTRANVLTF	other
CASSSDRDVGKLFF	NLVPMVATV
CASSDSGTTNEKLFF	other
CASSLLGDTEAFF	NLVPMVATV
CASSIRGARNEKLFF	NLVPMVATV
CASSPRDRGHSYNEQFF	other
CAWNRGSTDTQYF	other
CSAHLTPSYNEQFF	NLVPMVATV
CASSLQTGAGAYGYTF	NLVPMVATV
CASSLSGRVVYEQYF	other
CASSRDSTGYGYTF	other
CASSGDSSNEQFF	other
CASSDIQANTEAFF	NLVPMVATV
CASSIRSSSEQYF	other
CASSGRSTGEQYF	other
CASSPTGGSSYEQYF	NLVPMVATV
CNRPGQTNEKLFF	NLVPMVATV
CASSPGTATGELFF	NLVPMVATV
CASSYSQRTGVSNQPQHF	other
CASSFGVMEVLGDEQFF	NLVPMVATV
CASSLVAGASTDTQYF	NLVPMVATV
CASSPLRGQGDTGELFF	other
CASSTGQGMDTEAFF	other
CASSFVPGPQETQYF	other
CASSLTGVNTEAFF	NLVPMVATV
CASSLSRGDYGYTF	NLVPMVATV
CASSPVAGWYNEQFF	other
CSASPDRGNTGELFF	NLVPMVATV
CASSFPINRLVADTQYF	other
CSAQEGRGDTGELFF	NLVPMVATV
CASSDPFHNEQFF	NLVPMVATV
CASSIRSGHEQFF	other
CASSLPGNEQFF	other
CASSEAGVGTEAFF	other
CASSTGTGQPQHF	other
CASSESTGVEKLFF	other
CASGIRSSYEQYF	other
CASSLTQLWETQYF	NLVPMVATV
CATSLTSDHEQYF	other
CASSTRSGWELFF	other
CASSETGVVNEQFF	NLVPMVATV
CASSQGLGTSGPYEQYF	NLVPMVATV
CATSDPTGEDTQYF	other
CSARVGPQETQYF	NLVPMVATV
CAWSLNGDEQYF	other
CASSVSGDFTYNEQFF	NLVPMVATV
CASSHNWGDRDGQYF	other
CASSLGQGDGYTF	other
CAWSGGGDGYTF	NLVPMVATV
CASSLSVFKLYEQYF	other
CATSRVSGANVLTF	other
CSGYTGTEAFF	NLVPMVATV
CASSLTTGGKTGELFF	NLVPMVATV
CASSSGGGPQHF	NLVPMVATV
CASSFGLGADTQYF	other
CASSLRGRVRETQYF	NLVPMVATV
CASSPGRLLEQYF	other
CASSLNRDIQYF	NLVPMVATV
CASSSNRNTGELFF	other
CASTLGGGWGYTF	other
CASSYGLNQPQHF	other
CSASRGEVGELFF	NLVPMVATV
CSVAPSYNTGELFF	other
CSAREPNTEAFF	NLVPMVATV
CASSDPGGTGELFF	NLVPMVATV
CASSRGTSGRGNEQFF	NLVPMVATV
CASSLVRGISTDTQYF	NLVPMVATV
CASSDLGAGDQPQHF	NLVPMVATV
CASSLPGQGDEQYF	NLVPMVATV
CATSIGQSNTEAFF	NLVPMVATV
CATSNERGAQETQYF	other
CASGLYGNGPGADTQYF	NLVPMVATV
CASSLLTSGYEQYF	NLVPMVATV
CAISEEGGADEKLFF	NLVPMVATV
CASSTLAGPYNEQFF	other
CASSQETGLSNYGYTF	NLVPMVATV
CATSRRQGADEKLFF	NLVPMVATV
CASSIFFTGELFF	other
CASSIVPWGGADGYTF	other
CASSPWGIGGMNTEAFF	other
CASSYPEAYGYTF	other
CSAGRTVAGPGGAYNEQFF	other
CASSESNSVYEQYF	NLVPMVATV
CASRVSLPGNGANVLTF	other
CASSQASGRSHEQYF	NLVPMVATV
CASSLEGQGMNTEAFF	other
CQARDPVSGQGALLLYEQYF	other
CASSLVLGIRETQYF	NLVPMVATV
CASSTAQPQHF	other
CASSSSRTSEPYEQYF	NLVPMVATV
CASSSGGGEQYF	other
CASTLGCWGSVETQYF	other
CASSQDLRQGDQPQHF	NLVPMVATV
CASSFLGGQYNEQFF	other
CASSTTSGSYEQYF	other
CASSWTGTDHYEQYF	NLVPMVATV
CASSLAVDRGGYGYTF	other
CASNPFGASYNEQFF	other
CASSPFRTGIGNEQFF	NLVPMVATV
CASSRVIAGSDEQYF	NLVPMVATV
CSARDLSSNQPQHF	NLVPMVATV
CASSGQPYEQYF	NLVPMVATV
CASSEGDTQYF	NLVPMVATV
CASSRAGEETQYF	other
CASSFLAGLGDEQFF	NLVPMVATV
CASSLFGGSGNTIYF	other
CASSLERGLDTQYF	NLVPMVATV
CASSFLAGPDTPPNTGELFF	other
CASSSRDSYEQYF	other
CASSIVSIAGELFF	other
CSARDRDYGYTF	other
CATSSVGAQTQYF	other
CASSPETRGSGDYEQYF	other
CASNPPTDTQYF	NLVPMVATV
CSAPGQEISTEAFF	other
CASTSTGSGAKNIQYF	NLVPMVATV
CASDTFAGELFF	NLVPMVATV
CASSFVNQPQHF	NLVPMVATV
CASSHSAKCTAYEQYF	NLVPMVATV
CASSQVFRSAGPQPQHF	NLVPMVATV
CASSKLGGAGTGELFF	NLVPMVATV
CASSQEGIGRVEAFF	NLVPMVATV
CASNQVTETGAYGYTF	NLVPMVATV
CASTLIPSGGEQFF	other
CASSLPTEQETQYF	NLVPMVATV
CASSSHSLTMNTEAFF	other
CASGGTGATYSNQPQHF	other
CAASTGNYGYTF	other
CSADGDSYQETQYF	other
CASSPGLFLSNEQFF	other
CASSLIYPGELFF	other
CASSLVAGTGELFF	NLVPMVATV
CASSVTAGGPFLLYNSPLHF	NLVPMVATV
CATHGGEKLFF	NLVPMVATV
CAHSDSIGYTF	NLVPMVATV
CASSLIGRGRQETQYF	other
CASSLGALYGTEAFF	other
CASSRLAGGLRHEQFF	other
CASSIFAGVNQPQHF	other
CSPRPLSSYNSPLHF	NLVPMVATV
CASSIGLWGYTF	other
CASRDIHQQNTGELFF	other
CASRVEYVETQYF	NLVPMVATV
CASRKGERTLEAFF	NLVPMVATV
CASSPNGVETQYF	other
CASNGLSTGELFF	other
CASSFRDNEQFF	NLVPMVATV
CASSLGAGGLTGELFF	other
CASSTRGVGEQFF	other
CASSMGLDRGANNYEQYF	NLVPMVATV
CSATSGAISSSYEQYF	NLVPMVATV
CSAREQGVYTEAFF	NLVPMVATV
CASSLPGQGENTEAFF	NLVPMVATV
CASSARAQGEPYGYTF	other
CASSHEGSSGYTF	NLVPMVATV
CSARDQGGQGDSYEQYF	other
CASSMDSSYEQYF	NLVPMVATV
CATSSSGGGYNEQFF	other
CASSQERAGAGEQYF	other
CASLIVPWGTSGTTDTQYF	NLVPMVATV
CASSPRQGQLEQYF	other
CASRYSDTQYF	NLVPMVATV
CATSDPRDRAFYGYTF	NLVPMVATV
CASGIIAGGYNEQFF	other
CASVGVDTSYGYTF	NLVPMVATV
CSVDPTSGGETQYF	other
CASSLERHEQFF	NLVPMVATV
CASSVGGGNYNEQFF	NLVPMVATV
CASCIAPGVQETQYF	NLVPMVATV
CASSFYFTGAPHNEQFF	NLVPMVATV
CARSRTGEYTEAFF	other
CASSVLLLAGTYEQYF	NLVPMVATV
CASSLNRESPYEQYF	other
CASSQVVVSSSTNEKLFF	NLVPMVATV
CASSAGTSGGSTDTQYF	other
CASSQAPPVITGSPLHF	other
CASSLTGVDGYTF	other
CASSVDGGEQFF	NLVPMVATV
CASSLIGAGWDGYTF	other
CASSFGSRETQYF	other
CASSLRGADNEQFF	other
CASSIWGTYEQYF	other
CASSIGFYGYTF	other
CASSPSGGLENTGELFF	other
CASSSYNSPLHF	NLVPMVATV
CASSQEPSGSWGEQYF	other
CASSLLAGAGELFF	other
CASSYGGLGQPQHF	other
CSARDDRAQNTGELFF	other
CSVGEGQVTEAFF	other
CASSLLGVGEKLFF	other
CASSSVNGQFF	NLVPMVATV
CASRGTHTDTQYF	NLVPMVATV
CSASQGRYSNQPQHF	other
CASFRGNTIYF	other
CASTQGGLGLYGYTF	other
CATSPGTTYEQYF	other
CASSSSLGQGASRYGYTF	NLVPMVATV
CASGVVGGGAANEQFF	other
CAIRPTGISYEQYF	other
CASSERGSNQPQHF	other
CASSLRQMNTEAFF	NLVPMVATV
CASSPWEGGGELFF	NLVPMVATV
CASSPSGPSNQPQHF	NLVPMVATV
CASSPGLAGEDEQFF	NLVPMVATV
CANQDANTGELFF	other
CASSYSGTDTQYF	NLVPMVATV
CASSLGTMNTEAFF	NLVPMVATV
CASSQSSGGAYNEQFF	other
CASSPRGGAIYNEQFF	NLVPMVATV
CASSWTVNTEAFF	other
CASRKAGTRIYNEQFF	NLVPMVATV
CASSLEGGTEAFF	NLVPMVATV
CASSLVSGGAYNEQFF	other
CASSWGQGWRGYTF	other
CASSIRAGNEQFF	NLVPMVATV
CASYTGTGGNTIYF	other
CSARDRNHGARVLNTEAFF	NLVPMVATV
CASAGAGVEKLFF	other
CASSLGQYNSPLHF	other
CAWSETGLGTGELFF	other
CASSVYPPGQGRNEQFF	NLVPMVATV
CAWSEPNRVLREKLFF	NLVPMVATV
CASSFSGDYEQYF	NLVPMVATV
CASSWTGTEAFF	other
CASSSLDRADYGYTF	other
CSANSLSWPGEQFF	NLVPMVATV
CASSVLGGGEQFF	other
CASSQDQGTEAFF	other
CASSYEKGIMNTEAFF	other
CASSLLQAQRETTDTQYF	other
CASSLLGGYTF	other
CASSLLLGQGTNEKLFF	NLVPMVATV
CASSLLGYEQYF	NLVPMVATV
CSARDGTGNGYTF	NLVPMVATV
CAVLAEQNTGELFF	other
CASLVVGFYNEQFF	NLVPMVATV
CASSIISQNEQFF	other
CASSPHHGNTEAFF	other
CASKPSGGQETQYF	NLVPMVATV
CASMDKGERFDGYTF	NLVPMVATV
CASSSGWGVGAFF	NLVPMVATV
CASSNRGQRSPLHF	other
CSARELAGPGNEQFF	NLVPMVATV
CASSQISTDTQYF	other
CASSLTGSPYEQYF	other
CASSSGLALAEQYF	other
CSARDPGLGRSLSTDTQYF	other
CSVDLLDRYNEQFF	NLVPMVATV
CASSEGTISTGELFF	NLVPMVATV
CASSLGTSGGNEQFF	NLVPMVATV
CASSYDGRGPYQETQYF	NLVPMVATV
CASSLVRDGPYEQYF	other
CSAVESSYEQYF	other
CASSPHQAGGQTDTQYF	NLVPMVATV
CASSPTGGNQPQHF	NLVPMVATV
CASSLASSTEAFF	NLVPMVATV
CASSSQNTAEAFF	other
CATAIGHHPYEQYF	other
CASSLGGLGGRYGYTF	NLVPMVATV
CASSIYSGVGNEQFF	other
CASSLGVTNGETQYF	NLVPMVATV
CSARQPGGVDTEAFF	other
CSARGQSLYYSNQPQHF	other
CASSLSTGLGANVLTF	other
CASSYQGTEAFF	other
CASSQWVGTDLQETQYF	NLVPMVATV
CASNIRSSWELFF	other
CASSWGSEVVADTQYF	other
CASSRTSGGATDTQYF	NLVPMVATV
CASPPRHKYLPGETQYF	NLVPMVATV
CASRIQGYNEQFF	NLVPMVATV
CSVEDRGISGANVLTF	NLVPMVATV
CASGPGYGNTIYF	other
CASSKEQGAYGYTF	NLVPMVATV
CASRVPAYNEQFF	other
CASTWGLSSYNEQFF	other
CASRPGRLNEKLFF	NLVPMVATV
CASSTRSSTEQYF	other
CATSNWGMGSKDTEAFF	NLVPMVATV
CATSESTGLANQPQHF	other
CASSRWDRDYEQYF	other
CSFIPGHSYEQYF	NLVPMVATV
CASSVLNNEQFF	NLVPMVATV
CASSPLVAGELFF	other
CASSFYFTGAPYNEQIF	NLVPMVATV
CASTSGQTFPGELFF	other
CASSQDQVTQYF	NLVPMVATV
CASRWTGMHRSEKLFF	other
CASSQVEEFHGELFF	other
CASSGDIGGTEAFF	NLVPMVATV
CASSLRSSFVLGGREDGEQFF	NLVPMVATV
CASSEGLAGARTYNEQFF	other
CASSLAEARQYF	NLVPMVATV
CASSEWGTGGNEQFF	NLVPMVATV
CSARAIQREGFSYEQYF	NLVPMVATV
CASSHRTSSGYQETQYF	NLVPMVATV
CASSTRRTDTQYF	other
CATSPGLAGGWSDTQYF	NLVPMVATV
CASSQDWATVYEQYF	other
CASSLGRNEQFF	other
CASSGSGTGGRNTEAFF	other
CASSDLDTGELFF	other
CASSQTGYTEAFF	other
CAWTPDSDYSYEQYF	NLVPMVATV
CSALQGLTPEAFF	other
CATQRTNTGELFF	other
CASSLASGITDTQYF	NLVPMVATV
CSVEGDGTYEQYF	NLVPMVATV
CASSIGEGNGQFF	other
CASSLVGTEAFF	other
CASSQDAGTPAYEQYF	other
CTSSMRSADTQYF	other
CATGGWAGGPGEQFF	other
CASSSGTSGGSTDTQYF	NLVPMVATV
CASSSRADEKLFF	other
CASSYRRTNYGYTF	NLVPMVATV
CASTMEDGGQGDTQYF	NLVPMVATV
CASSPLSGNEQFF	other
CASSPDRANEQFF	NLVPMVATV
CSARVIDYLRGNEQFF	NLVPMVATV
CASSQVGGPDTQYF	other
CASSSGTGDKETQYF	other
CASSSAGPLTEAFF	other
CATSRGQAYEQYF	other
CASSFTGAYEQYF	NLVPMVATV
CASSIVSQGELFF	other
CASSRTAGTYYNEQFF	other
CASSSSDGDNEQFF	other
CASKDWYGNTIYF	other
CASSQQMVSSASGTALSGNTIYF	NLVPMVATV
CASSWTMNTEAFF	other
CASSLVSLAMEETQYF	other
CARDGKMNTEAFF	other
CSARDWDTQYF	other
CASSSGTPVYSGNTIYF	other
CASSVDPTGGGTGELFF	other
CASSLGGGQAGYEQYF	NLVPMVATV
CAWSVRQTTNEKLFF	NLVPMVATV
CASSGRSTDEQYF	other
CASSMRASHEQYF	other
CSAREGQPDYGYTF	other
CASSQGQLAGGLVF	other
CASSQGTGTGYEQYF	other
CASSALPAGGITGELFF	other
CASSLRSGTEAFF	other
CASEDRNTGELFF	other
CASSPDGTDTQYF	NLVPMVATV
CASSWRDSSYEQYF	other
CAWDVGTGPHEQYF	NLVPMVATV
CASSLLGDQPQHF	NLVPMVATV
CASSLGADNEQFF	other
CASIDRDRGNIQYF	other
CASSEGTGGGSTDTQYF	NLVPMVATV
CASSLALGTEAFF	other
CASSNRDRPYEQYF	NLVPMVATV
CASSLGLGVNTEAFF	NLVPMVATV
CASSIVALDTQYF	other
CASSFYRRELFF	NLVPMVATV
CASSRDGTGELFF	other
CASSPPGTKSNEQFF	other
CASSERRQGLGNQPQHF	other
CASSQSGDNTEAFF	other
CSADRTPGQGVHEQYF	other
CATSLTTDTGELFF	NLVPMVATV
CASSLFPGGNTGELFF	other
CASSLASGELFF	other
CASSSYSGNTIYF	other
CASSQGYSTDTQYF	other
CASSYLAGGTTDTQYF	NLVPMVATV
CSARDGTYYEQYF	other
CASSFLRRQTQYF	other
CSARPPGLAGGTTSTDTQYF	NLVPMVATV
CASSRPVGLGNEQFF	other
CASSDLYGNEQFF	NLVPMVATV
CASSARSMDIQYF	other
CASSARASDTQYF	other
CASSVVGGGAANEQFF	other
CASSSVDRGRFDEQYF	NLVPMVATV
CASSLGGDIQYF	other
CASSLYGANEQFF	NLVPMVATV
CATSPGTSGDNEQFF	other
CASSMGGVNTEAFF	other
CSARDRASAEQYF	NLVPMVATV
CASSLEPGGSSYNEQFF	NLVPMVATV
CATSGGWTYSNEQFF	other
CSVKWGAGELFF	other
CASTTGSGEQYF	NLVPMVATV
CASSLGNYEQYF	other
CSAQTKWYEQYF	other
CASSPPGLSQSYGYTF	NLVPMVATV
CANSARDHSDPNTGELFF	other
CASSPDRRSYNEQCF	NLVPMVATV
CASSHWREESEQFF	other
CASSLGVNTEAFF	NLVPMVATV
CASTGTGNYEQYF	NLVPMVATV
CASRLAGGNYNEQFF	NLVPMVATV
CASSVVPQQPQHF	NLVPMVATV
CASSLGGQKETQYF	NLVPMVATV
CSVYLLEAFF	NLVPMVATV
CATTGNWNTGELFF	other
CASSLDRGETQYF	NLVPMVATV
CASSLRNTEAFF	other
CASSPDIACTF	other
CASSPYSTGYEQYF	other
CASSQTQLWETQHF	NLVPMVATV
CASSPTREVGHGQFF	other
CASSASYYEQYF	other
CASGLSSYNSPLHF	other
CASSIFGGSAYNEQFF	other
CASSVGPLLRRLFF	NLVPMVATV
CSVVRDNGNEQFF	NLVPMVATV
CASLWEGLPNTGELFF	other
CATSEALYEQYF	NLVPMVATV
CASGTSWCGANVLTF	NLVPMVATV
CSARGVNTEAFF	other
CSVIWGRSTDTQYF	other
CASSTRFGNTIYF	other
CASSQAYSGGLGTDTQYF	NLVPMVATV
CASSLSSAGGYTF	other
CASSLGWAGKTDTQYF	NLVPMVATV
CASSQVGGVTEAFF	other
CASSAYDTDTQYF	other
CASSHGGGETQYF	other
CASSYRDRATNEKLFF	NLVPMVATV
CASSLTPGLTYEQYF	other
CASSPTGTGIETQYF	NLVPMVATV
CSARQGQGFLYEQYF	NLVPMVATV
CASSQNTGEDEQYF	NLVPMVATV
CASSSSGGGEDIQYF	NLVPMVATV
CASSWDDPGELFF	other
CASIPDRGSGNTIYF	other
CATSNNVGQTQYF	other
CASSHREGRRLANEQYF	other
CASSYFSGQGFSYEQYF	other
CASSPGWTNGAANYGYTF	NLVPMVATV
CASSLGPYNQPQHF	NLVPMVATV
CASSSDGYEQYF	NLVPMVATV
CASSPLFGGHQPQHF	other
CANFRTGGLFF	NLVPMVATV
CASSQDHGQGAEKLFF	NLVPMVATV
CASSPDGGSQPQHF	other
CASSIGTGELFF	other
CASSYFLAQTGINTGELFF	NLVPMVATV
CATSSGSSYEQYF	other
CASSSEGSGVQGEQYF	other
CASRMDIFRMGNTIYF	other
CSACLNLCHF	NLVPMVATV
CASSYGVYGYTF	other
CSAGTGDTYIQYF	NLVPMVATV
CASRPLGGSYNEQFF	NLVPMVATV
CASSVEVGRDEQFF	NLVPMVATV
CASSPGRPSYGYTF	NLVPMVATV
CASSQFELAGEETQYF	NLVPMVATV
CASSGGGQGYNEQFF	NLVPMVATV
CASSPALTGGLIEQYF	other
CASSQTSGSSYEQYF	NLVPMVATV
CVTSAPLRQGLFNYGYTF	other
CASSPIAGVSDEQFF	other
CASSLTFGGALETQYF	other
CASSVEGGVAQPQHF	other
CASKQGSNDEQFF	NLVPMVATV
CASSEVPGISNQPQHF	NLVPMVATV
CSVENQGAYGYTF	NLVPMVATV
CASHQGQFTDTQYF	NLVPMVATV
CSARDFSGREKSQYF	NLVPMVATV
CASSFRSGTEAFF	other
CASSLSLQGDGYTF	NLVPMVATV
CASRQQGWGYTF	NLVPMVATV
CASSSSGTVAKNIQYF	other
CATSRDRVSTDTQYF	other
CASSPDVGGSDGYTF	NLVPMVATV
CASSTRAGTPTDTQYF	other
CASSGTKETQYF	other
CASSSWEADTQYF	NLVPMVATV
CASNFTSDIQYF	NLVPMVATV
CASSLEEEGTNEKLFF	NLVPMVATV
CATQNLNTGELFF	other
CASTLTGFAEAFF	other
CSARLGRSYEQYF	NLVPMVATV
CASSPILGGTDTQYF	NLVPMVATV
CASSLQGNQPQHF	other
CASTGSNQPQHF	other
CASTASGGDTGELFF	NLVPMVATV
CASSMIGGGTQAFF	NLVPMVATV
CASSPDVAGNSYNEQFF	NLVPMVATV
CSARGVAGGRYEQFF	NLVPMVATV
CASSPGKGAYEQYF	other
CASSVRAADTQYF	other
CSARQGGLAKNIQYF	NLVPMVATV
CSVEDWTSGKETQYF	other
CASSLRGAGVTGELFF	other
CASSPVAGAPHKQYF	NLVPMVATV
CASREPSGRADEQFF	NLVPMVATV
CASSLDRHRRQGSWETQYF	NLVPMVATV
CASSIYGNTEAFF	other
CASSYLGRGEETQYF	NLVPMVATV
CSGGRASSNEQFF	NLVPMVATV
CASSGGGSGETQYF	NLVPMVATV
CASSPFGAGPYNEQFF	NLVPMVATV
CASSLEVSGDDEQFF	NLVPMVATV
CASSKSPTGTHSTDTQYF	NLVPMVATV
CASSLESRTYNEQFF	NLVPMVATV
CSAREIRDFAYEQYF	other
CASSIISGVEQFF	other
CASRGTGGYYEQYF	NLVPMVATV
CASSHEGSGCYTF	NLVPMVATV
CASSSGLAGGRDTDTQYF	NLVPMVATV
CASSGTTGTGPYGYTF	NLVPMVATV
CASSPPLQGSTTYEQYF	NLVPMVATV
CASSLVRASGSMEQYF	other
CATGDRNTDTQYF	NLVPMVATV
CATTIYEQYF	other
CASSLVGGGMGWEQFF	NLVPMVATV
CSARDSVAVNTGELFF	other
CATQGLNTGELFF	other
CATGGLNTGELFF	other
CATRFGNTIYF	NLVPMVATV
CASSVRSSTEQFF	other
CASINPMRAYQETQYF	NLVPMVATV
CATGVYRTYEQYF	other
CASSQGRLNYGYTF	NLVPMVATV
CASSIMSTDTQYF	other
CAWNIGGHTEAFF	NLVPMVATV
CASSPMVAGELFF	NLVPMVATV
CASSGRSAGEQYF	other
CASSLGQGGNEQFF	other
CASSNSLGGYTF	other
CSVELTVKETQYF	other
CASSQDLGGVMNTEAFF	NLVPMVATV
CASSQERGREEAFF	other
CASRDRTSGYNEQFF	NLVPMVATV
CASSVVAEDTDTQYF	NLVPMVATV
CASSSLQETQYF	NLVPMVATV
CASSLEIEAFF	other
CASSSIRTGTFDYEQYF	NLVPMVATV
CSVPSGGANTGELFF	other
CSARGLPYDHEQFF	other
CSVQGPEYEQYF	NLVPMVATV
CSAGPSGKNIQYF	other
CASSLVIGDRGHSEQYF	NLVPMVATV
CASSYIGVNQPQHF	other
CASSLIGGGMGWEQFF	NLVPMVATV
CASSWTGDNEQFF	NLVPMVATV
CASSLDRGSSYEQYF	NLVPMVATV
CSVESPMSNTEAFF	NLVPMVATV
CASSESGTGGYEQYF	NLVPMVATV
CASSPPGTSFNEFF	NLVPMVATV
CSARDLDRSVGELFF	other
CSARDLWGVNYGYTF	NLVPMVATV
CASSTRSSTEAFF	NLVPMVATV
CATSRDSTDWQYF	other
CASSYSMGVDYGYTF	NLVPMVATV
CASPNPWLTRIEAFF	NLVPMVATV
CASSSRTGTGETQYF	NLVPMVATV
CASSIFSEGVGTDTQYF	NLVPMVATV
CASSVGQDYSNQPQHF	NLVPMVATV
CSASQADMWGTQYF	other
CASSRRDSGANVLTF	other
CSALRLAGGLAHEQFF	other
CASSGVGNEPYNEQFF	NLVPMVATV
CASSGGHVEQYF	NLVPMVATV
CSARPRDREDNEQFF	other
CASSIRAGIEQFF	other
CATSSWDRSSGANVLTF	NLVPMVATV
CASSLNVGGEDTQYF	other
CASSMPGPINEQFF	other
CASSPGTAEKLFF	other
CSALAGGPDEQYF	NLVPMVATV
CASSFGGNTEAFF	other
CSARDLGTNTEAFF	NLVPMVATV
CSVGNEQFF	NLVPMVATV
CASSLDGGETQYF	other
CASSLYYLAPKTYEQYF	other
CASTWGRASTDTQYF	other
CASEQESSYNEQFF	NLVPMVATV
CASSMRSGSEHYF	other
CASSNRTSGASTDTQYF	NLVPMVATV
CSVEAGEETQYF	NLVPMVATV
CASSLLYQGGNEQYF	NLVPMVATV
CASKTVRGELFF	NLVPMVATV
CAIRTGGGEAFF	NLVPMVATV
CSARFEGGSRHTGELFF	NLVPMVATV
CASSRRSSDEQYF	other
CATSKWTGETQYF	other
CASATFSYNEQFF	other
CASGLAPGATNEKLFF	NLVPMVATV
CSARDYKTGVDYGYTF	NLVPMVATV
CASSQNPGTTNEKLFF	NLVPMVATV
CASANSVNEQFF	NLVPMVATV
CAISGDGGETQYF	other
CSGTGTQDREQYF	NLVPMVATV
CASSGAGAYNEQFF	other
CASSGRSSGELFF	other
CASSHGHLTEAFF	NLVPMVATV
CASSLRAGGERYF	other
CAWSVWDRGSGANVLTF	NLVPMVATV
CASSLAGGSDTQYF	NLVPMVATV
CASSLEGGTYEQYF	NLVPMVATV
CATSRGDTTDTQYF	other
CSATRGGRTDTQYF	other
CATSDPGLAGPGEQYF	NLVPMVATV
CATEDLNTGELFF	other
CASSRGQETGELFF	NLVPMVATV
CASSERTTSGEKLFF	NLVPMVATV
CVGSSPNTEAFF	NLVPMVATV
CASSPFPSGFTDTQYF	NLVPMVATV
CASSSLPREGGDTQYF	NLVPMVATV
CASSGGEGQPQHF	other
CATSEGSWSREKLFF	NLVPMVATV
CASSLTGAEEQFF	other
CSAAASGRSYEQYF	NLVPMVATV
CASSSRSGIEQFF	other
CSASLPTIF	NLVPMVATV
CASSLGAGIGYTF	other
CSARGELAVNTGELFF	other
CASSLEVTTNEKLFF	other
CASSTRSGNTIYF	other
CSNQPQHF	NLVPMVATV
CAISEGAGGQETQYF	NLVPMVATV
CASSQGPRTEAFF	NLVPMVATV
CASSLLNPLTEAFF	other
CATSEENTGELFF	other
CASRHDRGEQFF	NLVPMVATV
CASSLRGSGEQFF	other
CASSIYSGNEQYF	other
CASSDGTSAFPYEQYF	NLVPMVATV
CASSQGSGQGTEAFF	NLVPMVATV
CASSQDLSGGQETQYF	NLVPMVATV
CASSLATEYEQYF	NLVPMVATV
CASSPPSGSYEQYF	NLVPMVATV
CASSPPRDRDPSSWFF	NLVPMVATV
CATSVRSSYEQYF	other
CASSSDSSYEQYF	NLVPMVATV
CASSLDRGPWGNTEAFF	NLVPMVATV
CASSAGQGVWQYF	NLVPMVATV
CASSLVGRLHEQYF	NLVPMVATV
CASSVGQGAFQETQYF	NLVPMVATV
CASSSRHNEKLFF	NLVPMVATV
CASKFAGGPYEQYF	NLVPMVATV
CASSTRSSYNEQFF	other
CASSSQGYEQYF	NLVPMVATV
CASSPRGRLNEQFF	other
CASTPWGVGNTIYF	NLVPMVATV
CASSNRASYEQYF	other
CASSPRDDGGELFF	NLVPMVATV
CASSSTLAGEKKPYNEQFF	NLVPMVATV
CSAISRDLLYEQYF	NLVPMVATV
CSARGHTRSGTEAFF	NLVPMVATV
CSAPPGLAVYNEQFF	NLVPMVATV
CASSPTATHGYTF	other
CASSQDEGELKLFF	NLVPMVATV
CASSPSTTTGNIQYF	other
CASSLGPLFRENTEAFF	other
CATAMYGASYEQYF	other
CSARRLNTEAFF	NLVPMVATV
CASSLGMGQPQHF	other
CAISLKTSGETQYF	NLVPMVATV
CASSQDRGFGNQPQHF	NLVPMVATV
CSVELGSSYGYTF	other
CASSPPLGVDGYTF	other
CASSSSWGATEAFF	NLVPMVATV
CASSLNLGQGYTF	other
CASTFLTSGYNEQFF	NLVPMVATV
CASSGLATDTQYF	other
CASSIYGGGNTIYF	other
CSARLAGRPADTQYF	NLVPMVATV
CASSPFGGSIAKNIQYF	other
CASSFENSYEQYF	NLVPMVATV
CASSQDPSATDTQYF	other
CSGSLGETQYF	NLVPMVATV
CASSVTSGSYNEQFF	other
CASSTRSAETQYF	other
CASNLGIPASYEQYF	other
CASSRLYGNTRELFF	NLVPMVATV
CASSDSGQGWIEKLFF	NLVPMVATV
CASSARGGGITDTQYF	NLVPMVATV
CSARTDHNTGELFF	other
CASSTASYEQYF	other
CASSEANTGELFF	other
CASSEDAGLGAYGYTF	other
CSATQGWLTGELFF	NLVPMVATV
CASSYFRRLPGQVFYEQYF	other
CASSYTYEQFF	NLVPMVATV
CASSIFQGQPQHF	other
CASSLAGDTGELFF	other
CASSPETYYNEQFF	other
CANSQTQLWETQYF	NLVPMVATV
CASSGGGGHYGYTF	other
CASSWTGGLDTQYF	NLVPMVATV
CASSLQGWEPQHF	other
CASSPLLYEQFF	NLVPMVATV
CASGFYSNQPQHF	other
CASRFTSGSSYEQYF	other
CASSPSAGVVEQYF	NLVPMVATV
CASSTRSTEAQHF	other
CASSGIGRSKETQYF	NLVPMVATV
CSAGDRGVYEQYF	NLVPMVATV
CASSFPGGSDTQYF	NLVPMVATV
CASSPTGGYADTQYF	NLVPMVATV
CATAQGLSSYEQYF	other
CASSLGFGLRGDTQYF	other
CSARSWDRSELMGYTF	other
CSDSGGDNTDTQYF	NLVPMVATV
CSCGNANTGELFF	other
CASSIFSINEQFF	other
CASSGAGTIRGEEFF	NLVPMVATV
CASSSGQGLDTQYF	NLVPMVATV
CACSIRSTDTQYF	other
CASSWGTGGSTDTQYF	NLVPMVATV
CASLLQGVMGTDTQYF	other
CASSYSTSGGGYEQYF	NLVPMVATV
CASSARQRSYNEQFF	NLVPMVATV
CASKTGQGSTDTQYF	NLVPMVATV
CSASTENTGELFF	NLVPMVATV
CSGRINTEAFF	other
CSVEDLKGAEAFF	NLVPMVATV
CSVQRGQSYEQYF	NLVPMVATV
CASSPITQTGPLDTEAFF	other
CASRSPRAGETQYF	other
CASSLGGTAQGAVEAFF	other
CASSLGQGVLSDTQYF	other
CASSETGLFGGEAFF	other
CASSYSDRVHEQYF	other
CASSISATGELFF	other
CASSPRGDGSYTF	other
CSVAGFLAVYNEQFF	other
CASSQGSLNTEAFF	other
CASSLVDLRAGETEAFF	NLVPMVATV
CSAMIGVGGTDTQYF	NLVPMVATV
CASSLWEGTDEQFF	NLVPMVATV
CSVGGGGVDSYNEQFF	NLVPMVATV
CASSQETGATNEKLFF	other
CASSEESGAAETQYF	NLVPMVATV
CSARTLDGYTF	other
CASRPRQGRGSYNEQFF	NLVPMVATV
CASSLSLAGGLSEDYEQYF	other
CAAAERNTGELFF	other
CASSSVRSTDTQYF	other
CASTSMSKGRPYEQYF	NLVPMVATV
CASSELAGSYNEQFF	NLVPMVATV
CASGLGLYYEQYF	NLVPMVATV
CASSPQTGVGNYGYTF	NLVPMVATV
CASSLQGGDLDRRRPKSSPLHF	other
CSSRGGYEQYF	NLVPMVATV
CASRSRGAWETQYF	NLVPMVATV
CASSLGGSYEQYF	other
CASSLSGMLNQPQHF	NLVPMVATV
CASSLAGGYEQYF	NLVPMVATV
CASCRPPDRVDNEQFF	NLVPMVATV
CTSSQEGAGAPYNEQFF	other
CSARASPHTYGYTF	NLVPMVATV
CASSLGLEGWDEAFF	NLVPMVATV
CASEGLRYEQYF	NLVPMVATV
CSARGVGDSSYNEQFF	NLVPMVATV
CASSQDRAGGYGYTF	NLVPMVATV
CASSVGGPGELFF	NLVPMVATV
CASRGQFRGEAFF	other
CASSLGRNTEAFF	NLVPMVATV
CASSPAGLGQPQHF	other
CSARPSGGVSAYEQYF	other
CAWSVPDIMNTEAFF	NLVPMVATV
CASSYPREGHSNQPQHF	other
CASSLGGSSWDADTQYF	NLVPMVATV
CASSLGGSETQYF	NLVPMVATV
CASSLSAGETQYF	other
CASSEYRGKNTEAFF	other
CASSLDSEQFF	other
CASSQGTGAGANVLTF	other
CASSTYRVANEKLFF	other
CASLRSAVWADTQYF	other
CASSSTAGLAKNIQYF	NLVPMVATV
CSARLPGGVGTEAFF	NLVPMVATV
CASSLGWGSDAGYTF	NLVPMVATV
CSARDDRGATNEKLFF	other
CSANTLAGYNEQFF	NLVPMVATV
CASTGGYGYTF	other
CASSLGQSSGYEQYF	NLVPMVATV
CASTLGGSYEQYF	NLVPMVATV
CASDSGDHEQYF	other
CSASIERGGANEQFF	other
CSAPQRRETQYF	other
CASSPSLGGNQPQHF	NLVPMVATV
CASSPGPGETQYF	other
CSAAGTSGRTDTQYF	NLVPMVATV
CASSQVGEAGNTIYF	other
CASSSGLLGGQPQHF	other
CASSDGAILPGELFF	other
CSARHRGSGELFF	other
CASSPQTGTLSYGYTF	NLVPMVATV
CASSPTGGAGSTDTQYF	other
CASSLGAGTANRQFF	other
CASSYRAGGELFF	NLVPMVATV
CASTLVAGEGNEQFF	NLVPMVATV
CASSMRRGTDTQYF	other
CASSMRSGIEQYF	other
CASSPEIEAFF	other
CASSSLWPELFF	other
CASRGTGPETQYF	NLVPMVATV
CSARGDLRENSPLHF	other
CASSYLGGWNEQFF	other
CSARAGTSGIGEQYF	other
CASSYSTGAPSYEQYF	NLVPMVATV
CSALHRDSGNTIYF	NLVPMVATV
CASSLLFGGGDSYNEQFF	other
CASSAEALGGYFSGYTF	NLVPMVATV
CASSLFSETQYF	other
CASSPTGARGPNEKTVF	NLVPMVATV
CASSLWASHANEQFF	other
CASSYLGLAALETQYF	NLVPMVATV
CASSSGTSGGDEQFF	other
CASSFLGANEQFF	other
CSVPGGSGYTF	other
CASSGLQGTDTQYF	NLVPMVATV
CASSLLGITDTQYF	NLVPMVATV
CASSSRSQHEQYF	other
CASSLSGSGDEQFF	other
CASSVDRNSPLHF	other
CASSGARREPQHF	other
CASSWGTVYEQYF	NLVPMVATV
CSAHWGLESSPLHF	other
CATSRGQGATDTQYF	other
CSVSEGASEQYF	other
CSVAGFDSGNTIYF	other
CASSLWGQGAAGELFF	NLVPMVATV
CASSIVGSSYNEQFF	other
CASSYSIRDELNTEAFF	NLVPMVATV
CASSPRTVRLRETQYF	other
CSAPALGAMETQYF	NLVPMVATV
CAWSLWGSLNTEAFF	NLVPMVATV
CASSPHGGGNTEAFF	other
CASSQLTGEEQYF	NLVPMVATV
CATSLSGGGSDTQYF	NLVPMVATV
CASSLLGTGPEAFF	other
CAISGTGSYNEQFF	NLVPMVATV
CASSSGGREAFF	NLVPMVATV
CASRGLAVNEQFF	NLVPMVATV
CPILLGADGYTF	other
CASSQGDHSPLHF	other
CASSWTDENMNTEAFF	NLVPMVATV
CASSLERRIETQYF	NLVPMVATV
CASSLFPYRPEAFF	other
CASSYSGHVYEQYF	NLVPMVATV
CASSTTSGEETQYF	other
CASSMYDSNQPQHF	NLVPMVATV
CATSEGNLDQPQHF	NLVPMVATV
CASSGYTGELFF	other
CSVEWVHEQYF	NLVPMVATV
CSVYPGQNNEQFF	NLVPMVATV
CASSDDNTGELFF	other
CASSLNRPFTDTQYF	NLVPMVATV
CASSPGGRGNTEAFF	NLVPMVATV
CSATSPGTGIWEAFF	NLVPMVATV
CASSVIPGELFF	NLVPMVATV
CAWSVGNRGNEQYF	NLVPMVATV
CAWSYTDEAFF	NLVPMVATV
CASRTVNSYEQYF	NLVPMVATV
CASSPRTSGSSTDTQYF	NLVPMVATV
CASSLVDSIGEQFF	NLVPMVATV
CASSAGQPQHF	other
CASSQGPIKNIPYNEQFF	NLVPMVATV
CASSIRSGGTEAFF	other
CASSYGMEETQYF	NLVPMVATV
CAWSPRALGYSNQPQHF	other
CASIPDRNTGELFF	other
CASSLEFIYGYTF	NLVPMVATV
CASSDGRAWELFF	NLVPMVATV
CATRGQSTHGYTF	other
CASTQGSEAFF	NLVPMVATV
CASSHQLAGSTDTQYF	NLVPMVATV
CASSRGQGRETHEQYF	NLVPMVATV
CASRSGTGSPETQYF	NLVPMVATV
CASSLAGAGLPEAFF	other
CASSYSRQWNTEAFF	NLVPMVATV
CASSGGTGLIPYGYTF	NLVPMVATV
CASSLASVTFAAEQFF	other
CASTNLGTSQFYEQYF	NLVPMVATV
CSVGGTSGISSYEQYF	other
CATSDLTGNQPQHF	other
CASSIGLIGYTF	other
CASSNLAGGYNEQFF	other
CTSSHEGSGGYTF	NLVPMVATV
CASSLAGVGELFF	NLVPMVATV
CASSDLDSGVNTEAFF	other
CASSLARGNNEQFF	NLVPMVATV
CASSWNPSLYGYTF	NLVPMVATV
CASSPGSHFYGYTF	NLVPMVATV
CASSKGTGGLQETQYF	NLVPMVATV
CSANTGAVMNTEAFF	NLVPMVATV
CASVPYGYEQYF	other
CASSPVSGTGNYGYTF	NLVPMVATV
CASSPTSGGYEQYF	other
CASSSLRRGDNEQFF	other
CAISDTTGVREQYF	other
CASRGEQGYQETQYF	other
CSALSGNQNYNEQFF	NLVPMVATV
CASSWGTAEQFF	other
CSARTGEGQETQYF	other
CASSYNPETFHSNQPQHF	other
CASSFPGTGEETQYF	NLVPMVATV
CASSWTGTSVGPEETQYF	NLVPMVATV
CASSIRAGWEQYF	other
CASQGGLNTEAFF	other
CASSIGQAIYGYTF	other
CASSYSDTDTQYF	NLVPMVATV
CSAVDRPLEYQPQHF	other
CASSLGQGVFYEQYF	NLVPMVATV
CARQDTNTGELFF	other
CASNNRASNEQFF	other
CASSWGQGSYEQYF	other
CASSPDRGHGYTF	NLVPMVATV
CASSYSPGTGLPGELFF	other
CASSQVPDRGREQYF	other
CAREGGNYGYTF	NLVPMVATV
CASSQGFSGADTDTQYF	other
CASSLNRDEKLFF	NLVPMVATV
CSARDRPHGYTF	other
CSDPSCRRKSGANVLTF	NLVPMVATV
CSAFMADGYTF	other
CASSPPTGSNTEAFF	other
CASSVGASGGFNEQFF	NLVPMVATV
CASSLGGYNEQFF	NLVPMVATV
CASSLGTLSGQPQHF	NLVPMVATV
CASSPAPSASSYEQYF	other
CASSDASTEAFF	NLVPMVATV
CASSFRGSYNEQFF	NLVPMVATV
CASSLEGPGGGEQYF	other
CAWTLAYFTDTQYF	NLVPMVATV
CASNTRATYEQYF	other
CASSFRQSNYNEQFF	NLVPMVATV
CSARGQQGAHEQYF	other
CASSSYSVDTQYF	other
CASNLLGDDNEQFF	other
CATRRGEGQEKKQPQHF	NLVPMVATV
CASSLFQATSGGVDTQYF	NLVPMVATV
CASSLLAGGTDTQYF	NLVPMVATV
CAWSAGQGMNTEAFF	other
CASSQEDGTGSAGELFF	other
CAITEGGAHNYEQYF	NLVPMVATV
CAWSVIGGVSEQFF	other
CASSYSMDGHSNQPQHF	other
CASSEGGQAYNEQFF	other
CAFF	NLVPMVATV
CAITHPPIGETQYF	other
CASSQDRVSANNEQFF	NLVPMVATV
CASRQGDNSPLHF	other
CASSEDPGASTDTQYF	other
CATENRGYSYNEQFF	other
CASSLLRLAGGETQYF	NLVPMVATV
CASSRNRDSLQETQYF	other
CTVVETEAFF	other
CASSLSWGQETQYF	NLVPMVATV
CASALGGYNEQFF	other
CASSPGTSGAFAVNEQFF	NLVPMVATV
CASSTGTGQPQHF	NLVPMVATV
CASSETEGFYEQYF	NLVPMVATV
CASSSGTGAEYQETQYF	NLVPMVATV
CAISPLGTQIFSGNTIYF	NLVPMVATV
CASSSGESGNTIYF	NLVPMVATV
CASQYSNTGELFF	other
CASSRRTAGLNTEAFF	NLVPMVATV
CASSMFATDTQYF	other
CASIGERETQYF	NLVPMVATV
CASSLGGFNGYTF	other
CASSQGPGNTEAFF	other
CASSLWANTGELFF	NLVPMVATV
CASSPAPGTANTEAFF	NLVPMVATV
CASSLGTEAFF	NLVPMVATV
CSARAQGSLAKNIQYF	other
CASSVEGGASGNTIYF	other
CASSVLGSSYNEQFF	other
CASSLVEEEPTRGWPQHF	other
CASSIMIRSEAFF	other
CASSIDRGIYNEQFF	NLVPMVATV
CASSYHGLDEQFF	other
CASGREQYF	other
CASSQGTESYEQYF	NLVPMVATV
CALLLDWDTGELFF	other
CASSIAGGLREQFF	other
CASSLDSTYGYTF	other
CASSVGTSGTYEQYF	NLVPMVATV
CASSLARSGGTDTQYF	other
CASRGETQYF	NLVPMVATV
CASSLWWGIGNTIYF	NLVPMVATV
CASSSQGSNSYNEQFF	NLVPMVATV
CASSMTGYNEQFF	other
CASSFEMATFF	NLVPMVATV
CATLAEMNTGELFF	other
CASSYGLGNQPQHF	other
CASIKGLMNTEAFF	NLVPMVATV
CASSGVESSTDTQYF	NLVPMVATV
CASSPRSSDTQYF	other
CSVRAYSEETQYF	other
CASSEGNVAPGELFF	other
CSAVEREVTDTQYF	NLVPMVATV
CASSLGSGLVYEQYF	other
CSVAFGRRRPEAFF	NLVPMVATV
CASSIFGGFHNEQFF	other
CASSQVEDSNQPQHF	other
CASSNLPRDEQYF	other
CASRLGTGADTQYF	NLVPMVATV
CASSWSGTSYGYTF	NLVPMVATV
CASSYGGGSYEQYF	other
CTSSIRSSYEQYF	other
CASSSGTTSSYNEQFF	NLVPMVATV
CASSQGSGELFF	NLVPMVATV
CSALGTGRSYEQYF	other
CSVDSAGGNYEQYF	NLVPMVATV
CAWSWGQGVRELFF	NLVPMVATV
CASSRSGTIDEQYF	NLVPMVATV
CAWSLYYTGHEQYF	other
CASSIALSDNYGYTF	other
CASSLALANEQFF	other
CAISTSVSTDTQYF	other
CASSLVGQGAKSSYEQYF	NLVPMVATV
CSVSTAWDTEAFF	other
CASSIFPNPGNTIYF	other
CASSILAPPADYGYTF	NLVPMVATV
CASRQGPGELFF	NLVPMVATV
CASSPSGYNEQFF	other
CASSLDLAGGLAKNIQYF	other
CASSQFVYTSTDTQYF	NLVPMVATV
CSAREVDAPGTQYF	NLVPMVATV
CASSIGGDEKLFF	other
CSASLTGVGQPQHF	other
CSARDQSLAKNIQYF	other
CASSLGTDSGYGYTF	other
CSARALAGDTYNEQFF	NLVPMVATV
CASSPRDRGEFF	other
CASSFAGNQPQHF	NLVPMVATV
CASSQTGPTGELFF	other
CASSFYFTGAPYNDQFF	NLVPMVATV
CASSLAISYEQYF	other
CASSVSLAVSYNEQFF	NLVPMVATV
CSVDGRTGINEQFF	other
CASSPKTGAPLYGYTF	NLVPMVATV
CASSQGRLGRYF	other
CASTVGAVQPQHF	other
CSAYTSGGDEQYF	NLVPMVATV
CASSQGNRVENTEAFF	NLVPMVATV
CASRDRLAGGVETQYF	other
CASSSGAYGYTF	other
CASSMGQPKETQYF	NLVPMVATV
CASGDLSSGEQYF	other
CASSSYRDRESGANVLTF	other
CASSLDKDTQYF	NLVPMVATV
CASSFTTGYEQYF	other
CATSEGDALFQPQHF	other
CASGRGYTGELFF	NLVPMVATV
CASRDVVGRLSSYNEQFF	other
CASNIFGGGSEQFF	other
CASSQEEGPWNQPQHF	NLVPMVATV
CASSLYDGGTSTDTQYF	NLVPMVATV
CASLRGRPTDTQYF	NLVPMVATV
CASSQEGVGGFDIQYF	other
CASSLGTIQGANYGYTF	NLVPMVATV
CASSQGLAGDNEQYF	other
CASGVGPQETQYF	NLVPMVATV
CVSSQTQLWETQYF	NLVPMVATV
CASSPEPGLLNQPQHF	NLVPMVATV
CASSEIGAPGNTIYF	other
CASSSVAGGFFSYEQYF	NLVPMVATV
CASSPVLLVDEQFF	other
CASSELLAGGLETQYF	other
CAPQDLDTGELFF	other
CASSLGFGGATEAFF	other
CSVTFETGHTQYF	NLVPMVATV
CASSLLKGGGTDTQYF	NLVPMVATV
CSARTSGRVGEQFF	NLVPMVATV
CASSMVLGDTEAFF	NLVPMVATV
CASSIVGAAKNIQYF	other
CASSLKILTVGRYNEQFF	NLVPMVATV
CASSPLAGGATDTQYF	other
CASSLEGETQYF	NLVPMVATV
CASNHRGLGYEQYF	NLVPMVATV
CASSSPDVRTDTQYF	NLVPMVATV
CASSSGPEQYF	NLVPMVATV
CASGFFVDTAKNIQYF	other
CASSNGFHFNTLYF	other
CASREDGASGSPDTQYF	other
CASSFTLGTGGVEQYF	NLVPMVATV
CASSLTSGEETQYF	other
CASSIGQGSGYEQYF	other
CASSIVSGDEQFF	other
CSVPFAGADTQYF	other
CSVENSRSQETQYF	NLVPMVATV
CASSQGRRSTDTQYF	NLVPMVATV
CSAKTDRLAYEQYF	NLVPMVATV
CASNHEGSGGYTF	NLVPMVATV
CASSLGGTGAAGQPQHF	NLVPMVATV
CASNQVTGTEAYGYTF	NLVPMVATV
CASSPPGVRSLLQETQYF	NLVPMVATV
CAASEMNTGELFF	other
CASSQGTGELFF	other
CASSELNTGELFF	other
CASYTAGLNAEAFF	NLVPMVATV
CASSTRSGIEQFF	other
CASSHRTDYGYTF	NLVPMVATV
CAAQATNTGELFF	other
CASSFYF	NLVPMVATV
CASSMRASSPLHF	other
CASSWTSGAYNEQFF	other
CASSMLATDTQYF	other
CASNELNTGELFF	other
CASSPGGSLGGQDGYTF	NLVPMVATV
CASSGGHQNNEKLFF	other
CASAGLAGADEQFF	NLVPMVATV
CASSLDASGSSYNEQFF	NLVPMVATV
CATSDYSGSVNEQYF	NLVPMVATV
CASSGRSADTRYF	other
CASSLAQMNTEAFF	other
CASSIAGSGELFF	NLVPMVATV
CASRDGGRIDETQYF	NLVPMVATV
CASSYGYGYTF	NLVPMVATV
CASRPDRGGWQPQHF	other
CASSFRAALEQYF	other
CASSETSGGTDTQYF	other
CASSIRADDEQYF	other
CSGTDYYEQYF	NLVPMVATV
CASSILGGNEQFF	NLVPMVATV
CASSQDSIGFTGELFF	NLVPMVATV
CATKTGTAEKLFF	NLVPMVATV
CASSADERGGSYEQYF	other
CATQEGQLGNTIYF	NLVPMVATV
CASSEGFGGGTIYNEQFF	NLVPMVATV
CAISESRTGAYEQYF	NLVPMVATV
CAWTGDTEAFF	other
CAWSESYNEQFF	NLVPMVATV
CASTPSTGQKFLGGTF	NLVPMVATV
CASSLGGIGQPQHF	other
CASSIMGTDTQYF	other
CASSGGDWIEQYF	NLVPMVATV
CARLGIWYPAGGHEQFF	other
CASSTGGLAGEQYF	other
CASSSDRRDEPQHF	other
CASMGGLYEQYF	other
CASMGGNIQYF	NLVPMVATV
CASSDANTGELFF	other
CATSRERDTSYEQYF	other
CASSWTLNTEAFF	other
CSVVDAAPGANVLTF	other
CASSSIRGQGYEQYF	other
CASSETGSNTEAFF	other
CASSTVGEKLFF	NLVPMVATV
CASRPPQGVREQYF	NLVPMVATV
CAREQTGNTIYF	NLVPMVATV
CASSQERGAWLDTQYF	other
CASSMTGGPNQPQHF	NLVPMVATV
CASSQDWRAGAYNEQFF	other
CASRATGSNEQFF	NLVPMVATV
CASSLGQGSNEQYF	NLVPMVATV
CASRTGYTEAFF	NLVPMVATV
CATSTENTGELFF	other
CASRDRGLGQPQHF	other
CASSSLAGSTDTQYF	other
CASSIEGSSSYEQYF	NLVPMVATV
CAALAVDTQYF	NLVPMVATV
CASSFVGGQDGYTF	NLVPMVATV
CASSQWSGVGGGTEAFF	NLVPMVATV
CASSKREDYEQYF	other
CASSSRSGHEQYF	other
CASSFTVGGANVLTF	NLVPMVATV
CASSLSARSSYEQYF	other
CASAPGTGIYEQYF	other
CALWKGGRENTGELFF	other
CAPTPDQNTGELFF	other
CASSPRLGQGDYEQYF	other
CATHPWGAGGYTF	NLVPMVATV
CAISDLTNEKLFF	NLVPMVATV
CASMGRLAGIYEQYF	NLVPMVATV
CASSKGTGEMIQPQHF	other
CASSLSHIFVDGAVFG	other
CASSLERLAWDIQYF	NLVPMVATV
CASSIRTAANYGYTF	other
CASSETGVGQPQHF	other
CASAPGGSYEQYF	other
CATSTDGISNQPQHF	NLVPMVATV
CASSQTRGEGDEQYF	other
CASSTRTGNPYGYTF	NLVPMVATV
CASSVAAGLRDEQFF	NLVPMVATV
CASSGPVAEQFF	other
CSVVRGAYEQYF	NLVPMVATV
CASTEWTALSYNEQFF	other
CASSPWASGQQETQYF	NLVPMVATV
CASSSGTSGGETQYF	NLVPMVATV
CASSPWPEPNTEAFF	NLVPMVATV
CASSFRATSENTGELFF	NLVPMVATV
CASSPPGTGGPGELFF	NLVPMVATV
CASSETQMNTEAFF	other
CASSEWSHNTGELFF	other
CASSHDTPRCLNTEAFF	NLVPMVATV
CASSPFGGELFF	NLVPMVATV
CASSFVQDLGGYTF	other
CASSNSFGYTF	other
CASLSARGGYTQYF	other
CASSILDVSWTGSNQPQHF	NLVPMVATV
CATSGQPQETQYF	other
CASSPRPLSGNTIYF	NLVPMVATV
CASSWRAADTQYF	other
CASSPSGNEQFF	NLVPMVATV
CASSVGGVVYNEQFF	other
CASAGTGVEKLLF	other
CASSSAGVVHEQYF	NLVPMVATV
CASIDQNTGELFF	other
CASSLKPGTGPYNEQFF	NLVPMVATV
CASSQDPLGTTDTQYF	other
CASSQKGHQDTGELFF	other
CANSIRSSYEQYF	other
CASSNNGRFTEAFF	NLVPMVATV
CASSYGTGMNEQFF	other
CASRDSNTYEQYF	other
CASSEWARQNNSPLHF	other
CASSPGQGVDEQYF	NLVPMVATV
CATSDRLVPDTQYF	NLVPMVATV
CASSYFGANTEAFF	NLVPMVATV
CASSLDLRTGRTGELFF	NLVPMVATV
CASSVAMGLDYTF	NLVPMVATV
CASSLLLSGELFF	NLVPMVATV
CASSPEDSGVWETQYF	other
CASSLVRETADTQYF	NLVPMVATV
CASRMDRGTYEQYF	NLVPMVATV
CASSPSGGGYEQYF	other
CASSMGRNYGYTF	NLVPMVATV
CASSQGVGGPATNEKLFF	other
CASSLVAGGNTGELFF	other
CASGGGGAEAFF	NLVPMVATV
CAHQCVLLLSRGNDNEQFF	other
CASSHLGTGFWGELFF	NLVPMVATV
CASSSQAGAGDTYNEQFF	NLVPMVATV
CASSQEPGDEQFF	NLVPMVATV
CASSIGWHGYTF	other
CASSGVTYEQYF	other
CASSQASHQPQHF	NLVPMVATV
CSATWEQSGNGETQYF	NLVPMVATV
CASTKDRIKTQYF	NLVPMVATV
CASSQRSVGELFF	other
CSASGPKAGDFHYEQYF	NLVPMVATV
CASSESPGTAYEQYF	NLVPMVATV
CSARLLGSGDQETQYF	NLVPMVATV
CATSGNVGTEAFF	NLVPMVATV
CASSLDLYNEQFF	NLVPMVATV
CASRDTPYGYTF	NLVPMVATV
CASIPGDSNEQYF	other
CASSQAEGGRRLDTQYF	NLVPMVATV
CASSDLAGAGYNEQFF	NLVPMVATV
CASSFLGGITGELFF	NLVPMVATV
CASSLSLGGAAFF	NLVPMVATV
CASSYAPGQGNTGELFF	NLVPMVATV
CASRQQGGTEAFF	other
CASILMGQSLGTQYF	NLVPMVATV
CASSSRAGYEQYF	other
CASSRDKNYGYTF	other
CATSGLQGAHQPQHF	other
CAGSSRSGHEQYF	other
CASTKGGGELFF	NLVPMVATV
CASSLGSSGATNTGELFF	NLVPMVATV
CASSPATGVDQPQHF	other
CASSSGTDEEQFF	NLVPMVATV
CASSARFGTKQFF	other
CASRKEASLYEQYF	NLVPMVATV
CASSLTEAHGYTF	NLVPMVATV
CASSPTGDQPQHF	NLVPMVATV
CASSPDGSSYEQYF	NLVPMVATV
CASSLLKRFWETQYF	NLVPMVATV
CASSADFGGGEKLFF	NLVPMVATV
CPSSIGVYGYTF	other
CASSFLGLNEQFF	NLVPMVATV
CASSFGQGSTEAFF	other
CASSPVGGGNTGELFF	other
CASSLGQLHTWGNEQYF	NLVPMVATV
CALPSTDTQYF	NLVPMVATV
CASSELDSYTEAFF	other
CASSIYAALGTEAFF	other
CASSLFRGETQYF	other
CASSLAGIGNPYGYTF	NLVPMVATV
CASSLGTSLYF	other
CASSPHAGGEETQYF	NLVPMVATV
CSARVEFGTSRQLSSYNEQFF	NLVPMVATV
CASSIGLWRTEAFF	other
CSARDSGTGLPATYSGNTIYF	other
CASSPVTGAPHEQYF	NLVPMVATV
CASSPGAGEAFF	NLVPMVATV
CSATLTGLGQPQHF	other
CASSSGTVNNEQFF	NLVPMVATV
CATSAPLRQGLFNYGYTF	other
CASSTKETQYF	NLVPMVATV
CASSPAGVSYEQYF	NLVPMVATV
CASSTTGAYNEQFF	other
CAISLIYPGELFF	other
CASSLGGGNQPQHF	other
CASSKDGRSYEQYF	other
CASSQDQDGTDTQYF	other
CASLLYKGGANTEAFF	other
CASSEFAGDNNEQFF	other
CTSSQVGGPDTQYF	other
CASSLGQGPSYEQYF	NLVPMVATV
CATSDAPGTGIPYEQYF	other
CSASSSGVNIQYF	NLVPMVATV
CASSSPGWLAAYNEQFF	other
CATRRGDEQYF	NLVPMVATV
CASSLAGEQYF	NLVPMVATV
CASSFEGQLAYEQYF	NLVPMVATV
CASSFGGNEAFF	NLVPMVATV
CASSQDITVLYGYTF	other
CSARVWDSYEQYF	other
CASSAGTGGTEAFF	other
CASSIAVRNEQFF	other
CSARTTGGWEQYF	other
CASSEATGASYEQYF	other
CASSLSPAGTASYGYTF	other
CASSMWSAHEQYF	other
CSAFRDFSYEQYF	other
CAGQDLNTGELFF	other
CASSYSMMQDVSNQPQHF	other
CASSMIGTGALNEQFF	other
CASSILPPPAGLNNEQFF	NLVPMVATV
CASSAMGGAGVSDTQYF	NLVPMVATV
CASSPIGTAAELIHNEKLFF	NLVPMVATV
CASTAGLVPNEQFF	NLVPMVATV
CASSQDWAGGLEQFF	other
CAWRDRVGHQPQHF	other
CASSQAQLWETQYF	NLVPMVATV
CASSPVGTEQYF	NLVPMVATV
CSVDHLSRGVAEAFF	NLVPMVATV
CASSLDGDWRAQPQHF	NLVPMVATV
CASSLGGSNYEQYF	other
CATSDLRTGDLNEQFF	other
CASGLQGARDTEAFF	NLVPMVATV
CSASILFQGAWDEQFF	other
CASSQDSTDKGTQYF	other
CASSIFVGNEQFF	other
CASSYGLADHSGANVLTF	NLVPMVATV
CASSHTGSVNTEAFF	other
CATSPTANTEAFF	other
CASSSHHGQEQYF	other
CSATDRVTGNTEAFF	other
CASSQMTSGGVQFF	NLVPMVATV
CSVEDQQGYGYTF	other
CASSIGTSYNEQFF	other
CASSLGKAGLSNTEAFF	NLVPMVATV
CASRPQGDTEAFF	other
CASSTTVNTEAFF	NLVPMVATV
CASSITPTGELFF	other
CASSLTLAGGPGTYNEQFF	NLVPMVATV
CAGSHEGSGGYTF	NLVPMVATV
CASSHSSGFNYNEQFF	NLVPMVATV
CAGRITNTEAFF	other
CASSQDLLGVYNEQFF	other
CASSLEGLADTDTQYF	other
CASSVPGDNEQYF	other
CASSLNTDTQYF	NLVPMVATV
CASSDYLAPTDTQYF	other
CASSYIHEQYF	other
CASRKGTSGAYEQYF	other
CASSRTAQGDTEAFF	NLVPMVATV
CASSMFSSLNTEAFF	other
CSVLGRRVSYEQYF	other
CASSQAGMTEQFF	NLVPMVATV
CASSQSGGGPYEQYF	NLVPMVATV
CASSLTSDRAGVF	NLVPMVATV
CASSFAARSTGSANEKLFF	NLVPMVATV
CASRTGAYEQYF	NLVPMVATV
CASSPGSGNTIYF	other
CATSRAQGQTQYF	NLVPMVATV
CASKGRWGRGRAARDTEAFF	other
CASSDGAGTWDTQYF	other
CASSPLGGSYNEQFF	other
CASNPSLGFSYEQYF	NLVPMVATV
CASSFTGTQYF	NLVPMVATV
CASSGTGGFYEQFF	NLVPMVATV
CASSTNSYSRHEQYF	NLVPMVATV
CASRGRTQETQYF	other
CATSPTGTSGILSYNEQFF	other
CASSTTGTNSPLHF	NLVPMVATV
CASSHQGLAASYEQYF	NLVPMVATV
CASSFRASYEQYF	other
CASSWTSGGGNEQFF	other
CASSETGSSRNSPLHF	NLVPMVATV
CASSYSSGEPQHF	NLVPMVATV
CASSSRGFTYEQYF	NLVPMVATV
CASSYSPSGKEQFF	NLVPMVATV
CASSQEIGSSYNSPLHF	other
CASSIPPGYYNEQFF	NLVPMVATV
CASSLRGLEGYTF	other
CSARGMATSGGPTDTQYF	NLVPMVATV
CSASHRAGNEQYF	other
CASSLVTYPTDTQYF	other
CATSLGTSGRASEQYF	other
CASSLAGSPNEQFF	other
CSVAGGSGTEAFF	NLVPMVATV
CATARQGDQETQYF	other
CASSPAGASNGYTF	other
CSAWTSGNNEQFF	NLVPMVATV
CASCNQGVGQPQHF	other
CASSYGMFAEAFF	NLVPMVATV
CASSHPTGVFYGYTF	NLVPMVATV
CASGIPWEQYF	other
CASSLGTGHQPQHF	other
CASSYGQTNTGELFF	other
CASSFTDRVYEQYF	NLVPMVATV
CSATGQGAPNEQFF	other
CSARGYSAKNIQYF	NLVPMVATV
CASSQAGTGGYGYTF	NLVPMVATV
CSASFESRSYNEQFF	NLVPMVATV
CASSNLMLQGTGKLFF	other
CASSGQTGESQPQHF	NLVPMVATV
CASSDFRDRGHNEKLFF	other
CSVVGTINVQFF	NLVPMVATV
CASSIVVHGYTF	other
CASSPHQETQYF	NLVPMVATV
CASSHHGSGNTIYF	NLVPMVATV
CASSQGVDTSASYNEQFF	NLVPMVATV
CSARDLTGPNYGYTF	NLVPMVATV
CASSVGGTGVTLDTQYF	other
CASSFRPGGEQYF	other
CASSRTGTSEQYF	NLVPMVATV
CSVGEGNQPQHF	other
CASSQDLTGVQPQHF	NLVPMVATV
CASRLAGAADTQYF	NLVPMVATV
CASRGGGDNEQFF	NLVPMVATV
CASSARGQGRPGELFF	NLVPMVATV
CASSIRSATEAFF	other
CSAPASGREADTQYF	NLVPMVATV
CSPALGIYGYTF	other
CASSLESGEKLFF	other
CASSLGGGNTEAFF	NLVPMVATV
CASSSYLQDRGTGELFF	other
CSGSGASTDTQYF	NLVPMVATV
CASSRDSSSTDTQYF	NLVPMVATV
CASSPWSGGVVTEAFF	NLVPMVATV
CASSFYFTVAPYNEQFF	NLVPMVATV
CASSPVLDTEAFF	NLVPMVATV
CSAKDSFGPYEQYF	NLVPMVATV
CASSMGTGINEQFF	NLVPMVATV
CASSSRAAETQYF	other
CASSGWRGDLFEQYF	NLVPMVATV
CASSLNLRDREAYEQYF	other
CASSWTVLYGYTF	other
CASRDPHSPLHF	other
CASNIFRGGNEQFF	other
CASSLGGISEQFF	other
CSAREGTDFYEQYF	NLVPMVATV
CASSLGSFGYTF	other
CASRFGTEGSGANVLTF	other
CASSLAGVEQFF	other
CASSPGQGMAGELFF	other
CASSYGLSYEQYF	NLVPMVATV
CASSAGQGITEAFF	other
CASSDLNSGEQYF	other
CASSYFGGLTEAFF	NLVPMVATV
CASSWDIEAFF	other
CASSLEQGYEQYF	NLVPMVATV
CASSGINTGELFF	other
CASSGRATGKLFF	other
CSARSQRETNEQFF	NLVPMVATV
CSARDLPVLSGRYEQFF	other
CAAGGGAYTGELFF	other
CASQSGFSGANVLTF	other
CAISEGGLGTEYQETQYF	other
CASKDPGGFTEAFF	other
CASSLDGVTGELFF	NLVPMVATV
CAWSLVGLSYEQYF	NLVPMVATV
CASSLEEGPDEQFF	NLVPMVATV
CASSSHEGLETQYF	other
CASSLGGGSNQPQHF	other
CASSLVTGGPGEQYF	NLVPMVATV
CASSFGQGSYEQYF	other
CASSALAGGYNEQFF	other
CSASDGGGFNEQFF	NLVPMVATV
CASSLVSLGLAGGPGNEQFF	NLVPMVATV
CASSLATGGTDSPLHF	NLVPMVATV
CASSLGQGITEAFF	NLVPMVATV
CATILYEIPGSGGGPMGGAVFVQSCNIVGTGDNQPQHF	other
CASSPAGDYEQYF	NLVPMVATV
CATSDSRGYEQYF	NLVPMVATV
CASSRDLDYEQYF	NLVPMVATV
CASSPGRETAINQPQHF	other
CSAKRDRGVSYEQYF	NLVPMVATV
CASSQDEDGFMNTEAFF	other
CASREGNTGELFF	other
CASSPDGSGANVLTF	NLVPMVATV
CASSLAPLQGPSTDTQYF	other
CASSVGRFVGPYEKLFF	other
CAWSAERELFF	NLVPMVATV
CASSPWIDYSNQPQHF	NLVPMVATV
CASSFLPPQGDTDTQYF	other
CSARGEVPTSGRWEETQYF	other
CASSQTGNQPQHF	NLVPMVATV
CASETEGVLGGYTF	NLVPMVATV
CASRLLGVNEQYF	NLVPMVATV
CSVDEGGWLETQYF	other
CASTPLIGTGLDGYTF	other
CASSNGRVSGANVLTF	NLVPMVATV
CASSEEKGNNANTGELFF	NLVPMVATV
CASSAQLAPSYNEQFF	NLVPMVATV
CASRLGRVSNTEAFF	other
CASSYSGGSYIEFF	other
CASSQEGSSGTEAFF	other
CASSQLLAGGSYEQYF	other
CSVEDYGRVETQYF	NLVPMVATV
CASSPGGRSSYNEQFF	NLVPMVATV
CAISESTKSLLVQDTQYF	other
CASSLRDKLSWQETQYF	other
CASTDRDTETQYF	other
CSAMYGVNSPDTQYF	NLVPMVATV
CASSESTDTEAFF	other
CASNQVTGTRAYGYTF	NLVPMVATV
CASSQDLIWSYEQYF	NLVPMVATV
CASSLVGEYTGANVLTF	NLVPMVATV
CASSTWIRTNTEAFF	other
CASSFAGVNEQYF	NLVPMVATV
CASSKPGRIRPLHF	other
CSARGTANTEAFF	NLVPMVATV
CASSGDGYEQYF	NLVPMVATV
CASDGQGNGYTF	other
CASSDPLRKGADEQYF	NLVPMVATV
CASRGDGNTIYF	other
CASSRGPDTEAFF	other
CASIPIRWGDTGELFF	other
CASSLEQGAVDGNTIYF	other
CASSFAGQGSTEAFF	NLVPMVATV
CASSKGQGAYGYTF	NLVPMVATV
CASLSQNTGELFF	other
CASSSGGTEAFF	NLVPMVATV
CASSQEKGITGELFF	NLVPMVATV
CASRGLAVPTGEQFF	NLVPMVATV
CAWSVGGAGNTIYF	NLVPMVATV
CASSLDTEAYEQYF	other
CAPRPGPRSTDTQYF	NLVPMVATV
CASSQRNDLKAFF	other
CASSLGGQSGNYGYTF	NLVPMVATV
CASSSRLAGASTTQETQYF	other
CASSLGLASAYEQYF	NLVPMVATV
CSVDPGTGDGEQYF	NLVPMVATV
CASRGRDEKLFF	NLVPMVATV
CASSPGQVLPGEQYF	other
CASSYLGGAETQYF	NLVPMVATV
CASSIYGSSYNEQFF	other
CASSLLGISADTQYF	other
CASSQERGGYNEQFF	other
CASSYNEQFF	NLVPMVATV
CASSGPGQDYGYTF	other
CAWTRSETQYF	NLVPMVATV
CSARPRTSGPYNEQFF	NLVPMVATV
CASSLAGGAGTEAFF	NLVPMVATV
CASSAVSSTDTQYF	other
CASRGLGGSSYNEQFF	other
CASTRTSGRRSGELFF	NLVPMVATV
CSVDPPEGSDTQYF	NLVPMVATV
CSARSAPGTALGTPSTAGTDTQYF	NLVPMVATV
CASRTGHNEQFF	NLVPMVATV
CASSIEGPTGELFF	other
CASSSRDLEAFF	NLVPMVATV
CSAPGPGVSVEKLFF	other
CASSMTSRGEQFF	other
CATSDPIRASSHEQFF	other
CAAPLGSNQPQHF	other
CASSEAELLSSYNEQFF	other
CASSDTNTGELFF	other
CASSMFGKETQYF	other
CASSFGQGNTGELFF	NLVPMVATV
CASSPNRQGHGHGYTF	NLVPMVATV
CSAGRYQETQYF	other
CASSTRGLRSGNTIYF	other
CSVEGEGGSYEQYF	NLVPMVATV
CATQVDQNTGELFF	other
CASRPSGSELIYEQYF	other
CASSSGLVAPGELFF	other
CASSHESSGGYTF	NLVPMVATV
CASSLTSGSSYEQYF	NLVPMVATV
CSVELRNEQFF	NLVPMVATV
CASRPTGLAENTGELFF	other
CASSAFPTAHNQPQHF	other
CASSGPANTGELFF	other
CASSIFGRGEQFF	other
CASSQDTSGGFYGYTF	NLVPMVATV
CASSLPSRQSFSYEQYF	other
CASRWTEFSEQFF	NLVPMVATV
CASRTQGEVGELFF	NLVPMVATV
CASSELGTGDYEQYF	other
CASSSRLAGKGNEQFF	NLVPMVATV
CASSSQGDQGADTQYF	other
CASSQESPDRGLTETPDRVGTEAFF	other
CSARDWASGGTDISYEQYF	NLVPMVATV
CASSILASSYNEQFF	other
CASSPRSGVGAFF	other
CASSTTSGGEQYF	other
CASSSQGGNYGYTF	other
CASSYFGGALSEQYF	other
CASSYGRETGELFF	NLVPMVATV
CTSSQAPFWASNQPQHF	NLVPMVATV
CSVVESYEQYF	NLVPMVATV
CASSFQRAGELFF	other
CASSLTGGAGAFF	other
CASSLLYGGGFQTQYF	NLVPMVATV
CASDVGTGGLPHGYTF	other
CASSLAPGATNQKLFF	NLVPMVATV
CASSQAVGRPIYEQYF	other
CASSEAHNYEQYF	NLVPMVATV
CASSTGGGTEAFF	other
CASSLWGFDRTDTQYF	NLVPMVATV
CATSQTSANTGELFF	other
CASEMSGSVDEQYF	NLVPMVATV
CASSIGSPSGRANEQFF	NLVPMVATV
CASSEDRGLADTQYF	NLVPMVATV
CASSFGGNAYNEQFF	NLVPMVATV
CSVDGGGAVPLDTQYF	other
CASSHTQGNTEAFF	NLVPMVATV
CASSLTGDSGYEQYF	NLVPMVATV
CASSIGSAMGDIQYF	NLVPMVATV
CASSLERNFDTEAFF	other
CASSTFGANVLTF	other
CASSYQANTGELFF	NLVPMVATV
CASSQGGASGGDTQYF	NLVPMVATV
CASRLDSLNYGYTF	NLVPMVATV
CASSYRGSGNTIYF	other
CASSLRTGSYEQYF	other
CASSLAGQGALSRQYF	other
CASSYAISYEQYF	other
CAISESGELNQPQHF	NLVPMVATV
CASSFPGAEAFF	NLVPMVATV
CASSFTGGRTEAFF	other
CASSPVGGSSGNTIYF	NLVPMVATV
CASREFQGLAYEQYF	other
CSVVGSPKGYNEQFF	other
CASSQVSAELYGYTF	NLVPMVATV
CSATREDTQYF	other
CASSPTGTEAFF	other
CASSLVWGSGGTDTQYF	NLVPMVATV
CAAGAGLSYEQYF	NLVPMVATV
CAWGTLATEQYF	other
CASSEGQGTMNGELFF	NLVPMVATV
CASSLELGNPQYF	NLVPMVATV
CASSSGLAGGPITGELFF	NLVPMVATV
CASSGNGINSPLHF	NLVPMVATV
CASSLDGALVTDTQYF	NLVPMVATV
CASSSLADFYQPQHF	other
CASSTNFKNTEAFF	NLVPMVATV
CSASPPASSGQPQHF	NLVPMVATV
CASSGTQETQYF	other
CASSGSGTSAKNIQYF	other
CASSAVPWGETQYF	other
CASSYGQGLYGYTF	NLVPMVATV
CSAVSDSSYNEQFF	NLVPMVATV
CASSWTGNTEAFF	other
CASSIRSGWELFF	other
CASNQVTATGAYGYTF	NLVPMVATV
CASSWLAGDNEQFF	other
CAGSQTQLWETQYF	NLVPMVATV
CASSKPKGHHPIPPFNTGELFF	NLVPMVATV
CASSIYALGELFF	other
CASGSEAFF	other
CSARDQRTSLYNEQFF	NLVPMVATV
CPSSIFGGKEAFF	other
CPSSHEGSGGYTF	NLVPMVATV
CASSTLLAVSSYNEQFF	other
CASSFGQGLSNEQFF	NLVPMVATV
CASSLRSSGELFF	other
CASRGSDNYYEQYF	NLVPMVATV
CASSLVGGGREYTGELFF	other
CASSLSRDSYEQYF	NLVPMVATV
CASSIATGSEQFF	NLVPMVATV
CASSAGLYGYTF	other
CASSFLEGTEAFF	NLVPMVATV
CASSSGGDSNQPQHF	NLVPMVATV
CSARDPPRVNTGELFF	other
CSARDRQEETQYF	other
CASSLQVTGTNYGYTF	other
CASKGGSSGTDTQYF	NLVPMVATV
CASSDSSHEGQGAYEQYF	other
CASSLGDTEAFF	other
CSVKSGDRGESPQETQYF	other
CASSLKTGFDEQFF	NLVPMVATV
CASTPFGGAGYGYTF	other
CASSTRSTVEQYF	other
CASSLQVLGGETQYF	NLVPMVATV
CASRPGELLLHF	NLVPMVATV
CASVLSASGYNEQFF	NLVPMVATV
CSFRTAMNTEAFF	NLVPMVATV
CSVGLAGVNEQFF	NLVPMVATV
CATSIDTSPLHF	NLVPMVATV
CASSQPSGKTQYF	NLVPMVATV
CASSMLGEQFF	NLVPMVATV
CAARDQRDLNTGELFF	other
CASSERGPNYGYTF	NLVPMVATV
CSARAGGDGETQYF	NLVPMVATV
CASSQPDRARGETQYF	NLVPMVATV
CASSPLAGAQYQETQYF	other
CASTPLEQGQGPMNTEAFF	other
CASSTRRTDTQYF	NLVPMVATV
CASSSTYPQSTDTQYF	NLVPMVATV
CASSLQSLLDEKLFF	other
CASSGPGEYNEQFF	NLVPMVATV
CASTDRDRGHEQYF	other
CATSAGNTGELFF	NLVPMVATV
CASMGGAGELFF	other
CASSIGTGEAFF	other
CASSPPVSTDTQYF	NLVPMVATV
CASTPLNTGELFF	other
CASSFGDHLPNYGYTF	other
CASRDRVEQYF	other
CASSSGTGHTGELFF	NLVPMVATV
CSVGQPANYGYTF	NLVPMVATV
CASSGEKVRENIQYF	NLVPMVATV
CASSEPTGGETQYF	NLVPMVATV
CSGIVLAGADNEQFF	NLVPMVATV
CASSLLSGGQEKLFF	NLVPMVATV
CASGRGTRTYEQYF	other
CASNYLSDLRYNEQFF	NLVPMVATV
CASSQVGIHGYTF	NLVPMVATV
CASSIRSGIEQFF	other
CASSEWTYTGELFF	NLVPMVATV
CASSLFATNTDTQYF	other
CASSYGLADYEQYF	NLVPMVATV
CASSQGVFGQPQHF	other
CASSPGLLNEKLFF	NLVPMVATV
CASSPGDLYGYTF	NLVPMVATV
CASSQDSGGTDTQYF	other
CASSRNGVRQPQHF	other
CASGIGVGGYTF	other
CASAGISTDTQYF	other
CASSPRYNTYNEQFF	NLVPMVATV
CASSLGGLRTEAFF	other
CSVMLANQETQYF	other
CASSLVGGGPQHF	other
CASSPGEARGEQFF	NLVPMVATV
CASSRLGTGELFF	NLVPMVATV
CSAPVVTGPTDTQYF	other
CASSLAVQSDEQYF	other
CASLPWAGGPYNEQFF	other
CSVDADHNTGELFF	other
CASSFGRSNEQFF	NLVPMVATV
CASDSNTEAFF	other
CSVDSGRAGYEQYF	NLVPMVATV
CASSPRTGGRWQYF	other
CASNLAGARETQYF	NLVPMVATV
CSVDREISGNTIYF	other
CASSQGSDEPNTGELFF	NLVPMVATV
CASSLAAGGRDQPQHF	NLVPMVATV
CASSLTGVGNEQFF	other
CASSYAASVLEQYF	other
CAWSDHNSKELFF	other
CASTQLEGTQYF	NLVPMVATV
CSARENWDLSTDTQYF	other
CSVVAPGQGIYGYTF	other
CASSLYFTGAPYNEQFF	NLVPMVATV
CATRQETNEKLFF	NLVPMVATV
CSARDRTNYGYTF	NLVPMVATV
CSARDVDSQETQYF	NLVPMVATV
CSARRWQGPRTKNTGELFF	other
CASSLRSSDTQYF	other
CASSFRLQRESDTEAFF	NLVPMVATV
CASSPGTSDPANYGYTF	other
CATASLAEENIQYF	NLVPMVATV
CATSDPQREVNTDTQYF	NLVPMVATV
CSARGWSSYEQYF	other
CSVAGTVNEQFF	NLVPMVATV
CASSRGLAGGYNEQFF	NLVPMVATV
CASSFGLTSSYNEQFF	other
CASRGGVWNTEAFF	NLVPMVATV
CASSLGQTPYEQYF	NLVPMVATV
CASSATSTGELFF	NLVPMVATV
CASCPGPEGTDTQYF	NLVPMVATV
CAWSVRQGGNTIYF	NLVPMVATV
CASSPGWANTGELFF	other
CASTGGYGYTF	other
CASSRGASRETQYF	NLVPMVATV
CASSIRSGIEAFF	other
CASSESWDTQYF	other
CASSHRSTGELFF	other
CASSVADNPYNEQFF	NLVPMVATV
CASSSHEGSGGYTF	other
CSALRTDYYEQYF	NLVPMVATV
CASSFGSGNNEQFF	other
CASAGTADNEQFF	other
CASSYGTGFEAFF	NLVPMVATV
CASSLGSGSEQYF	NLVPMVATV
CASRPPTGGEKLFF	NLVPMVATV
CASSEATGGYEQYF	other
CASSLGTGGVTDTQYF	NLVPMVATV
CASSLMGTSGFTGELFF	NLVPMVATV
CASSLAAGLGDTQYF	NLVPMVATV
CSARGTSYGGRGPEQYF	NLVPMVATV
CASSPILGQESSYEQYF	NLVPMVATV
CASSYLSDLRYNEQFF	NLVPMVATV
CASSPRTQETQYF	other
CASSPALLAGVHYEQYF	NLVPMVATV
CASSLMGPDTQYF	NLVPMVATV
CASSQERWGGGNTIYF	other
CASGGGLYEQYF	other
CATSREQGDTGELFF	other
CASKARGSPLHF	other
CASTMGLAGGGGTDTQYF	NLVPMVATV
CSARDLAGENTGELFF	other
CATSDYPSGGPPRCTDTQYF	other
CASSTGTSGGTDTQYF	other
CASRLNPTNEKLFF	other
CASSLAQGWTEAFF	NLVPMVATV
CATSDWSGGPGGDEQFF	other
CASSIYSINEQFF	other
CASSPPAVGTEAFF	other
CASSWDRGSAGELFF	NLVPMVATV
CSVEGSSEQYF	NLVPMVATV
CAWNTVGTSSEAFF	NLVPMVATV
CASSFAGTANAKNIQYF	other
CASSILTGPQPQHF	other
CASSYGQGADEQFF	other
CASSFGQGSDTQYF	other
CASSWGVGQGFTGELFF	NLVPMVATV
CASSFRGAGDQPQHF	other
CASSGANTGELFF	NLVPMVATV
CAYQEVNTGELFF	other
CASSLAPGGSGQETQYF	NLVPMVATV
CSARGGVANEQYF	other
CASSIGGWNEQYF	other
CASSYPIQGTSNQPQHF	other
CSARSGLAGGGDTQYF	other
CASSFLAGEGYEQYF	NLVPMVATV
CASSYSIAGHEQFF	NLVPMVATV
CSVEGQEGGYTF	NLVPMVATV
CASNAGSTNYGYTF	other
CSVLEMNTGELFF	other
CASSEGRVAPGEQYF	other
CASSELGTVPGNTIYF	NLVPMVATV
CASSLRDEQYF	other
CSANILGAVRAENEQFF	other
CASSLTGGGNTGELFF	other
CASGEENTGELFF	other
CASSLIPRTGNINQPQHF	NLVPMVATV
CAVLGGLEDNSPLHF	NLVPMVATV
CASSSMDGNYGYTF	NLVPMVATV
CASSPEGAQPQHF	other
CASSATTSYNEQFF	NLVPMVATV
CASSQGGTQYF	other
CARPQETQYF	NLVPMVATV
CASSIFDTANQPQHF	other
CASSVVPSSYEQYF	other
CASSQGTMADTQYF	NLVPMVATV
CASSLQGRGNQPQHF	other
CSVETRSSYEQYF	NLVPMVATV
CASSVEGPGELFF	other
CASSEYVQYYGYTF	other
CSARDQAAQNTGELFF	other
CASSGGGAIHNEQFF	NLVPMVATV
CASSEGNTGELFF	NLVPMVATV
CASNAGDTEAFF	other
CSVRAPPMTSPTDEQYF	other
CATRSGGPHEQYF	other
CASTSVGGSGEAFF	other
CATFDGNTGELFF	other
CASSPAYQETQYF	NLVPMVATV
CASSQTQLWKTQYF	NLVPMVATV
CASSMRSNQPQHF	other
CASSLEAGAYEQYF	NLVPMVATV
CASSPYSNQPQHF	NLVPMVATV
CASSHDPLEQYF	NLVPMVATV
CASSLAPGGATNEKLFF	NLVPMVATV
CASSLGGGTEAFF	NLVPMVATV
CASSISTAKNIQYF	other
CASSPGDRGIGGAQYF	NLVPMVATV
CASSPAGPQETQYF	NLVPMVATV
CSVDPDNDNEQFF	NLVPMVATV
CASSPTGWTAFF	NLVPMVATV
CASSNANTGELFF	other
CASTKTSGAPYEQYF	NLVPMVATV
CASSYYAAGLGTGELFF	NLVPMVATV
CASGWGEQFF	other
CASSQTQALEKLFF	NLVPMVATV
CASSWVNTEAFF	other
CASSPDRYQETQYF	NLVPMVATV
CASSLNQQAFF	other
CASSFYPITRGGKTGELFF	other
CASSLEWDRNQPQHF	NLVPMVATV
CASSEQGPTTYYEQYF	NLVPMVATV
CASSVDARGQDALNYGYTF	other
CDLRPDSSEGNQPQHF	NLVPMVATV
CASSQGPLITEAFF	other
CASSLAGGGETQYF	other
CASSQLLAGVTDTQYF	NLVPMVATV
CASSSTWDGSYNEQFF	NLVPMVATV
CASSQRSTNTQYF	other
CASSFEENSNQPQHF	NLVPMVATV
CSVEVGAGETQYF	other
CASSVGAGGDGELFF	other
CSVDGDSVAFF	other
CASSQDYSSYEQYF	NLVPMVATV
CASSLGGQGYEQYF	NLVPMVATV
CASSPGGNTQYF	NLVPMVATV
CASSQPWVAGGQNEQFF	NLVPMVATV
CASRSGAEVFF	other
CSARQGDTEAFF	NLVPMVATV
CASPGGWIWIPQYSNQPQHF	other
CATSRGTSETHTGELFF	other
CASSQDLGSGNEQFF	other
CASTTDRGYGYTF	NLVPMVATV
CASSYLVGRGAIAHYGYTF	other
CSATDREYEQYF	other
CASSLRGAVDTQYF	other
CASSLRGPGLYNEQFF	other
CASSTRDLLYQETQYF	other
CASSLGTGGDLHF	other
CASSPGPWNEKLFF	NLVPMVATV
CSARDQGSEQYF	other
CASSLGPIDEQFF	NLVPMVATV
CASSPAFSPKNQPQHF	NLVPMVATV
CASRKDNGVAGELFF	other
CASSYSNRGWDTEAFF	other
CASSHGGGQNTEAFF	NLVPMVATV
CASSMVSIDEQFF	other
CASSTLRYEQYF	other
CASSPPTVTYTDTQYF	NLVPMVATV
CATSRDTPQTDQETQYF	other
CSAHAGTGGAETQYF	other
CASSPSTTLSSGASGETQYF	other
CTSSFYFTGAPYNEQFF	NLVPMVATV
CASSSDIQQFF	other
CASSDLDNLVAFF	other
CASSQGTSGGLSTDTQYF	other
CASSLSGTAYEQYF	other
CANSSLSGPYEQYF	NLVPMVATV
CASSSRASGEGEQFF	other
CSVAETYEQYF	NLVPMVATV
CSVEGGWGTGELFF	NLVPMVATV
CASSYMTGDQPQHF	NLVPMVATV
CASRSVAEAFF	other
CASSQSNRANEQFF	NLVPMVATV
CASSFGGQPQHF	NLVPMVATV
CASDRGASTDTQYF	NLVPMVATV
CASSSRAAAEAFF	other
CASSLVASGSLRGSQYF	NLVPMVATV
CASRWTGEYEQYF	NLVPMVATV
CASSIRSAETQHF	NLVPMVATV
CASSIRSGDKQFF	other
CASSMGNYGYTF	other
CASRFYFTGAPYNEQFF	NLVPMVATV
CASSLVRGDTEAFF	other
CASSLVWSSGGQETQYF	NLVPMVATV
CASSLGSYGYTF	other
CASSPNPGGLNGYTF	other
CSVEEDRNTGELFF	other
CASSHGMVAFF	other
CSVEGDSYEQYF	other
CASSGGSRGGSTGELFF	NLVPMVATV
CAISERNYRERDGYTF	NLVPMVATV
CASSVGAPGGDEQFF	NLVPMVATV
CSAPGQGFNEKLFF	other
CASSIRSSGEQFF	other
CSARDFGSPYNEQFF	NLVPMVATV
CASRRTGGRETQYF	NLVPMVATV
CANSQVIDQETQYF	NLVPMVATV
CAWSLTINTEAFF	NLVPMVATV
CASSLAGGYGYTF	other
CASSRGQAPGYTF	NLVPMVATV
CSVVPRGTEAFF	NLVPMVATV
CASSWRDRGHGNTIYF	NLVPMVATV
CASSESTDEKLFF	NLVPMVATV
CASSPRGPYNEQFF	NLVPMVATV
CASSFTGSTDTQYF	other
CASSESGTEHEQYF	NLVPMVATV
CASSLGRNSGNTIYF	other
CASSSVSYSNQPQHF	other
CASRPHVPPLAGPANTGELFF	other
CASSQRGGIEQFF	other
CASSRHPGGTDTQYF	other
CASSQVGQGNYGYTF	NLVPMVATV
CSAYDREQETQYF	NLVPMVATV
CATRREVGYGYTF	other
CASSFGGAETQYF	other
CASSSIGQYNSPLHF	NLVPMVATV
CASSCTGTGETPF	other
CASSTPGEGGEQFF	other
CASSPDIGGYQPQHF	NLVPMVATV
CASSIFGGAETQYF	other
CASSQARRGFEDTIYF	NLVPMVATV
CASSLDLGASTDTQYF	other
CSSTGTEGYTGELFF	other
CASSLDRDLYEQYF	NLVPMVATV
CASTSGNEQFF	NLVPMVATV
CACLGTGTYEQYF	NLVPMVATV
CASSVGQGSQPQHF	NLVPMVATV
CASSSPYDDQLGDTQYF	NLVPMVATV
CASSVLAGSSYEQYF	NLVPMVATV
CASSQDLGTGRTEAFF	other
CASSLGSHTEAFF	other
CASSQELSGDTQYF	other
CASSIISGDTQYF	other
CSVDGVRGNYGYTF	NLVPMVATV
CSARVGLAGDRNEQYF	NLVPMVATV
CASSLVTGPGTDTQYF	NLVPMVATV
CARGESNTGELFF	other
CAWTEAENTEAFF	NLVPMVATV
CASSQVGHHGYTF	NLVPMVATV
CASSFSGQPKAFF	NLVPMVATV
CASRELSQYF	NLVPMVATV
CASSITGAFGTEAFF	other
CASIPGQGNGYTF	other
CASSLWEIYNEQFF	other
CASSMTSGSLNEQFF	other
CARGQEDLYGYTF	other
CASSRAGQGHGHLDGSGNTIYF	NLVPMVATV
CASSLESRGSGVTDTQYF	NLVPMVATV
CASSELAGGNTGELFF	other
CASSGYRGLAGNNEQFF	other
CASNSPGLLTDTQYF	NLVPMVATV
CASNLYGQHNEQFF	other
CAWSWAAATSYEQYF	NLVPMVATV
CAEGELNTGELFF	other
CSVDIGEAFF	other
CSADDRTSGNTIYF	other
CASSPQATSYNSPLHF	NLVPMVATV
CASSEAGGGELFF	other
CASSYSGGEASPLHF	NLVPMVATV
CATHELNTGELFF	other
CSAPETAEAYNEQFF	NLVPMVATV
CAGSLAPGATNEKLFF	NLVPMVATV
CASSDGTASTDTQYF	NLVPMVATV
CASSPLFGNTIYF	other
CASSIRLAGPYNEQFF	NLVPMVATV
CAIRDVEETQYF	NLVPMVATV
CASSPTLRPPIAKNIQYF	NLVPMVATV
CASSLELAGLDNEQFF	NLVPMVATV
CSVGNSGYQETQYF	other
CASSLVGVPNYGYTF	other
CSPLGRKGVNTEAFF	NLVPMVATV
CASRAGHGSPGDTQYF	NLVPMVATV
CASSAEDRQYYNEKLFF	other
CASSFSRNSPLHF	NLVPMVATV
CASTLIGDSGMVNEQFF	NLVPMVATV
CASSEYFGQGKNEQYF	other
CASRLQGLGQPQHF	other
CSVETGIGYEQYF	NLVPMVATV
CATSVRAGGQKVNEQFF	NLVPMVATV
CASRWRGEGYGYTF	NLVPMVATV
CASSQEPPTASGANVLTF	NLVPMVATV
CASSKTGELFF	other
CASSSPGQDYGYTF	NLVPMVATV
CASRPRTGRGVYNEQFF	NLVPMVATV
CASSLSGGQYF	NLVPMVATV
CASSSRDGNNEQFF	NLVPMVATV
CSATPWVGLSFSNQPQHF	NLVPMVATV
CSVEGVTGPANEQFF	NLVPMVATV
CASSYSRSQIYEQYF	NLVPMVATV
CASSQPAGESLRETQYF	NLVPMVATV
CASSYGVLGQPQHF	other
CARSLAPGATNEKLFF	NLVPMVATV
CASSWGLAGANNEQFF	other
MSLLGSNQPQHF	other
CAGADSNTGELFF	other
CATSSDHRDRELDTQYF	other
CASSSILRGAANTEAFF	other
CASTPWVAGGGELFF	NLVPMVATV
CSAVPGLALGEQYF	NLVPMVATV
CASSSGTAQAYNEQFF	other
CASSGWTKNIQYF	NLVPMVATV
CASSLNPSSYEQYF	NLVPMVATV
CASSLSHEGRNTEAFF	NLVPMVATV
CASSLTPGLSYEQYF	other
CSVRTGVAEGYTF	other
CASSSLGTGGYGYTF	other
CASSLGTGMVTDTQYF	other
CASSLRKGFDEQYF	other
CASSQDPSGRGNTIYF	NLVPMVATV
CASSLTQNSNQPQHF	other
CATSRDFTNYGYTF	NLVPMVATV
CASSGELLSNTEAFF	other
CATSRPGWTGGTEAFF	NLVPMVATV
CASSPTGEVPFF	NLVPMVATV
CASGIRSVAEAFF	other
CASSILFGQGGNQPQHF	NLVPMVATV
CSVGDGNTGELFF	NLVPMVATV
CASSTRDSLLETQYF	NLVPMVATV
CSAPGPGPYEQYF	other
CASSFGENTEAFF	NLVPMVATV
CASSSNDALAGGYEQFF	NLVPMVATV
CASSQLAGGQGEQYF	other
CASSIISQETQYF	other
CASSLTGSGTEAFF	other
CASSLGTNANTGELFF	NLVPMVATV
CASSLGDSYEQYF	NLVPMVATV
CASSTTGFTDTQYF	other
CASSPREPMRLAGAPSTDTQYF	NLVPMVATV
CASSLRSGDTQYF	other
CASSPRSGTEQYF	other
CASGLGGETQYF	NLVPMVATV
CASSIARDEQFF	other
CASRPGARQETQYF	NLVPMVATV
CASRQALQETQYF	other
CASSYSMGASYNEQFF	NLVPMVATV
CASSLDRTDYGYTF	NLVPMVATV
CASSRRGTGELFF	NLVPMVATV
CASSLDVPDTQYF	NLVPMVATV
CSARVARGYEQYF	NLVPMVATV
CASGGTSTDTQYF	other
CASRTQSSYEQYF	other
CAISEPGQQLYGYTF	other
CASSHRDGQDQPQHF	other
CASSQNIDYEQYF	other
CASTLGTANNEQFF	other
CASSHEGSGSYTF	NLVPMVATV
CASSPRGMRADGTDTQYF	NLVPMVATV
CASSIGTGFTEQFF	other
CASRTGDNEQYF	NLVPMVATV
CASSLLGAYTGELFF	NLVPMVATV
CASSYNRGPSQPQHF	NLVPMVATV
CASSVDIEAFF	other
CASSYAQGNEQFF	other
CASTLPGGRGPEGYTF	other
CASTSQSELFF	other
CASSEAPRVGNQPQHF	other
CASSSRDGTYEQYF	NLVPMVATV
CASSYNIAGELFF	other
CSARGEQPRQDEQYF	other
CSASLSESSYEQYF	NLVPMVATV
CSARDLGYGLYNEQFF	NLVPMVATV
CASSQLLAGGSGNIQYF	NLVPMVATV
CASSALAGARYEQYF	NLVPMVATV
CASSPPGQNYGYTF	NLVPMVATV
CASSPGTGTYEQYF	other
CASSYRDTGELFF	NLVPMVATV
CASSLSAGAPGAEAFF	NLVPMVATV
CASSIFGSPRGEQYF	other
CASSFVGATNEKLFF	NLVPMVATV
CASTMITGLGSNYGYTF	other
CASSSRDRATGELFF	other
CASSRTGKAYNEQFF	NLVPMVATV
CSADSAGGNTGELFF	NLVPMVATV
CASSQEETGDLSETQYF	NLVPMVATV
CASSQVGQAIYGYTF	other
CASSLTGSTPTDTQYF	other
CASSSSGSSYEQYF	other
CSVDLRYTGELFF	NLVPMVATV
CASSSRSSAEAFF	other
CASSFQETQYF	NLVPMVATV
CASSPDIQAFF	other
CASSLSSGGNYEQYF	NLVPMVATV
CASSEPHGLNQPQHF	other
CASSFSETQYF	NLVPMVATV
CASSLFQGSSPLHF	NLVPMVATV
CASSGTGGADEQYF	NLVPMVATV
CASSAGGAYEQFF	NLVPMVATV
CASSIVSRAEQYF	other
CSVEGLYEQYF	NLVPMVATV
CASRRGGGDTQYF	other
CSVRGPKGATNYGYTF	NLVPMVATV
CASREGGNEAFF	other
CASSYAVSDTQYF	NLVPMVATV
CAWSPPAVSGANVLTF	NLVPMVATV
CASSDTGGRDEQFF	other
VQGVPGPGVNEQFF	other
CASSLNRGQFF	NLVPMVATV
CASIDENTGELFF	other
CASSLSYGGLLDTEAFF	other
CASRVTGTQYF	other
CATSQGAWYEQYF	NLVPMVATV
CASSLGGPTEAFF	other
CASSMRSGVEQFF	other
CASRWGGSAGTDTQYF	other
CASSFTGIAETQYF	other
CASSPRPGQGNFFF	NLVPMVATV
CASIPSSGEQYF	NLVPMVATV
CASSSARATEAFF	NLVPMVATV
CASSIFAGGFTEAFF	other
CASSLVGLYSNQPQHF	other
CASSSDINYGYTF	other
CSARDLGGTAKNIQYF	NLVPMVATV
CATREEVGGGSPLHF	other
CAITNRVGTEAFF	other
CASRPQTGTIYGYTF	NLVPMVATV
CASSLAGSNYGYTF	NLVPMVATV
CASSFKQGPDEQYF	other
CASSYRSTDTQYF	other
CASRLMNTGELFF	NLVPMVATV
CAISGLAGVNEQFF	NLVPMVATV
CASSGTNQNIQYF	other
CASNSDRDDLLNTEAFF	NLVPMVATV
CASSLNTGGTDTQYF	other
CASQDREGRGYTF	NLVPMVATV
CASSWGQGSTDTQYF	other
CAHRENTEAFF	NLVPMVATV
CASSLLVGRVNTEAFF	other
CASSYTGELFF	other
CASSYSGWRLHF	other
CASSQGDGGELFF	NLVPMVATV
CASSQEQAEPYEQYF	NLVPMVATV
CASSYNTEAFF	other
CASSVRSPYEQYF	other
CASSIAPTDGEAFF	other
CASSLALAGGFMGNTEAFF	other
CASSYSEGSYEQYF	other
CASSLVDSGLMDEQYF	other
CASSWAAPGEQFF	other
CASSEDSFNQPQHF	NLVPMVATV
CASSASYEQYF	NLVPMVATV
CASSLTQGNYEQYF	other
CASSIHSGQPNTQYF	other
CASSPEAGWDAHNEQFF	NLVPMVATV
CSPGRGQGSSYNEQFF	NLVPMVATV
CASSPWTSANEQFF	NLVPMVATV
CSARSRQGQNTGELFF	other
CASSLYNEQFF	NLVPMVATV
CASSLGVNTGELFF	other
CASSQLGTDTQYF	NLVPMVATV
CSVTHRGGEQYF	NLVPMVATV
CASSLMGQGLSSYNSPLHF	NLVPMVATV
CASSIRAASEAFF	other
CSARDLLAETYEQYF	NLVPMVATV
CASSDPGDYGYTF	NLVPMVATV
CASSFPGRLAGQVSSYNEQFF	NLVPMVATV
CASSYSAVQGNNQPQHF	other
CASTFSLEKLFF	other
CASSLGSGGYTDTQYF	NLVPMVATV
CASSDHSLAVFENEQFF	NLVPMVATV
CTSSPGGRTDSPHTDTQYF	NLVPMVATV
CASSTPATGQLETQYF	NLVPMVATV
CASSLDGNYSNQPQHF	NLVPMVATV
CASSLVGRLTVDEQYF	other
CASTRDTEAFF	other
CASSLGGANVLTF	other
CASSDPGILPGPQHF	other
CATSRPNRGEAFF	other
CASSLATGRHNEQFF	NLVPMVATV
CASSAGTDLISPLHF	NLVPMVATV
CASSMVGGPGNEQFF	other
CASSQEALMGEQYF	other
CASSLYTAYEQYF	NLVPMVATV
CASSDKPGLAGPDTQYF	NLVPMVATV
CSAGQGSDYGYTF	NLVPMVATV
CASSIRSTSPLHF	other
CASSVDVAGGYNEQFF	NLVPMVATV
CSARPPALESQYF	NLVPMVATV
CASSLAGGAAEKLFF	NLVPMVATV
CASSLRSSNEQFF	other
CASSEDGMNTEAFF	NLVPMVATV
CASSPLRETGISGANVLTF	other
CASSREYTDTQYF	NLVPMVATV
CASSVNSNQPQHF	other
CASSLRVKPYGYTF	NLVPMVATV
CASSGRDSHEQYF	NLVPMVATV
CASSGRSNRPQHF	other
CASSLGGELFF	other
CASLTRLAGGLYEQYF	NLVPMVATV
CASSFGVGETQYF	NLVPMVATV
CASSVYGGVSYNEQFF	other
CSASYGAGESQPQHF	NLVPMVATV
CASRGIAGTPRTSTDTQYF	other
CASSFESYNEQFF	NLVPMVATV
CSANSIKRGLNYGYTF	other
CASSVVDGLAETQYF	other
CAGSQAGMAEQFF	NLVPMVATV
CSARPEEKLFF	other
CASSQGAHGYTF	other
CASSNFDSSYEQYF	other
CASSEWTGYQPQHF	NLVPMVATV
CASSGHGADTQYF	other
CASSLAVAGVQETQYF	other
CAWSTLGQVNYGYTF	NLVPMVATV
CASSLEGGQGIPEAFF	NLVPMVATV
CASSIRGSGELFF	other
CASSPGAAGTEAFF	NLVPMVATV
CASRPTTSSYNEQFF	NLVPMVATV
CASSFGQGADEQYF	other
CASSPGGSPEQYF	other
CASSYPTGEQYF	other
CASSLSPLAGGISSYNEQFF	NLVPMVATV
CSARNNQGEAQPQHF	NLVPMVATV
CASSTHGADTQYF	other
CAGYFNYGYTF	NLVPMVATV
CASSQDGGETQYF	other
CASSLEVTMNTEAFF	NLVPMVATV
CASSLEVGNQPQHF	other
CASSLRAGKTQYF	other
CASSQDSKGPTSYEQYF	NLVPMVATV
CASSLPSSWNYGYTF	other
CASSMGFGQPQHF	other
CASSERDRTTNEKLFF	other
CASSISPTPRQGQFF	other
CASSITGTYNEQFF	other
CSARPMTSGPYNEQFF	NLVPMVATV
CASSSRDGYQNTEAFF	other
CASSQVGYDGYTF	NLVPMVATV
CASSQEGWYNEQFF	other
CASSPLGQNTEAFF	NLVPMVATV
CASTFRDSRREQYF	NLVPMVATV
CASSFGQGAYEQYF	NLVPMVATV
CASSQGDGANVLTF	other
CASSPSGTVYGYTF	NLVPMVATV
CASSQRAYEQYF	other
CASAKGYGYTF	other
CSARYDTGELFF	other
CASSQMSGGAYNEQFF	other
CASRFVGGTSCNEQFF	other
CASSYRGQVSYEQYF	NLVPMVATV
CASSFIGTNNNEQFF	NLVPMVATV
CASSSRDKPQETQYF	NLVPMVATV
CASSVVGHLGEKLFF	other
CASSPETSEPHNEQFF	other
CASSPRAGETQYF	other
CASTSGVLAKNIQYF	other
CASSQGGVLRGETQYF	NLVPMVATV
CASSPVSGYNEQFF	NLVPMVATV
CASGGGSEQFF	NLVPMVATV
CSARDLRTFRTDTQYF	other
CAIRKTENTEAFF	NLVPMVATV
CASSTPSRGIQPQHF	other
CSARDLKGSSYNEQFF	NLVPMVATV
CSASLAGGPFQETQYF	other
CASSFATGPFLEQYF	NLVPMVATV
CASSLDSTGYTF	NLVPMVATV
CASSPLTGPPYEQYF	other
CASSYSIGALEAFF	NLVPMVATV
CASSLTYGYTF	NLVPMVATV
CASSTSSSEQYF	NLVPMVATV
CASSLGVNEQFF	NLVPMVATV
CASSSTGGGLYEQFF	NLVPMVATV
CASSWTGGGVYGYTF	other
CANSFRSGETQYF	other
CASSQDLQGTNEKLFF	other
CSARDQVRANYGYTF	NLVPMVATV
CSARDSAIGANPERNYGYTF	other
CASFISGGADDTQYF	NLVPMVATV
CASSEGSYEQYF	NLVPMVATV
CASSWTVNYGYTF	other
CTSSIRSSTEAFF	other
CATGTSGFSTDTQYF	other
CSASEGNQPQHF	NLVPMVATV
CASRPPRGGEKLFF	NLVPMVATV
CSVNRWGNEKLFF	NLVPMVATV
CASSQDGPPKPEEQETQYF	NLVPMVATV
CATSGTGDNEQFF	NLVPMVATV
CASTLPGPEAFF	NLVPMVATV
CSARDVEGMNTGELFF	other
CASSSQLERSYTGELFF	other
CATSRDIEFSLYGYTF	NLVPMVATV
CARSQTQLWETQYF	NLVPMVATV
CASSLAQGLNEQFF	other
CASSLGVYEQYF	NLVPMVATV
CASSPGGTGDEKLFF	NLVPMVATV
CASSLSGRDYGYTF	NLVPMVATV
CASSYSGGAYGYTF	other
CSVEDGDERGRYIQYF	NLVPMVATV
CASRWASGGYEQYF	other
CASSMRSQETQYF	other
CSARDGLAGFSYEQYF	NLVPMVATV
CASSEALAGGGTDTQYF	other
CAIRDGRHSYEQYF	NLVPMVATV
CSVAAGGRGYTF	NLVPMVATV
CASSQWTQHF	other
CASSLKTGAVYGYTF	NLVPMVATV
CASSIGQYEQYF	other
CASTWPGEFDEQYF	NLVPMVATV
CASSFSFRMNSPLHF	NLVPMVATV
CASSLGMGQPQHF	other
CASSPGLTYQPQHF	other
CASRPIRADRVTTGELFF	other
CASNQDPGGQETQYF	other
CASSPGVNTEAFF	other
CASSFDQGTGGFRETQYF	NLVPMVATV
CASSEWVAFSYEQYF	NLVPMVATV
CAISGQAVSTDTQYF	other
CASSPTAGGDTGELFF	other
CASSYRFF	other
CASSQDLWTGTYEQYF	other
CASSFEGLSYEQYF	other
CASSLGGPYEQYF	NLVPMVATV
CASSPGTSGRIDEQFF	other
CATSTGGQGPDTQYF	other
CASSDAGGSGNTIYF	other
CSARDTSGRAMDEQFF	other
CSVEDYSTGIISGNTIYF	NLVPMVATV
CASRWDSSYNSPLHF	NLVPMVATV
CASSPGLNTGELFF	NLVPMVATV
CSARESAYNSPLHF	other
CASSYPLAGGTYEQYF	other
CASSSRSTGEQFF	other
CASKPSQALIEGYGYTF	other
CSARDSGAGTDTQYF	NLVPMVATV
CAASDPNTGELFF	other
CASNPGRLRSPLHF	other
CASSLATGTGWDQPQHF	NLVPMVATV
CASSLAPDRGETQYF	other
CASSSARQRNYGYTF	NLVPMVATV
CASSSRTGWASAFF	NLVPMVATV
CASSLGMGTEAFF	other
CASSPTGARGPNEKLFF	NLVPMVATV
CASRTLSGTLAGELFF	NLVPMVATV
CARSCEIVQRYGGCEQFF	NLVPMVATV
CASSFIHREEGYTF	other
CASSFGLGGSYGYTF	other
CASSIIAGDVDEQFF	NLVPMVATV
CSARYQAGTETQYF	other
CATSDPGTSGSYEQYF	NLVPMVATV
CTSSQGSYGYTF	other
CASSQDRELAFF	other
CASSLIGRGTYEQYF	NLVPMVATV
CASSLIGGTAGANVLTF	NLVPMVATV
CASSSRGSSYEQYF	NLVPMVATV
CASSVGGAHNEQFF	other
CASTEGTGWTEAFF	other
CASSLFVTEAFF	NLVPMVATV
CASSIALYNEQFF	NLVPMVATV
CASSLASKGDYEQYF	NLVPMVATV
CASSLLGLAGDYEQYF	NLVPMVATV
CSVEGGMGQPQHF	other
CASSQRESYNEQFF	NLVPMVATV
CASSFYNEQFF	NLVPMVATV
CASSEVKGAIEAFF	NLVPMVATV
CASSEVWGREVSLPSTDTQYF	NLVPMVATV
CASSPNFGEAFF	NLVPMVATV
CASSMEASGSSYNEQFF	NLVPMVATV
CASSLSEGWIYEQFF	NLVPMVATV
CASSLGVLSLGREQYF	other
CASRDEGLAEYEQYF	NLVPMVATV
CASSPMAEAFF	other
CASSIRATWEQYF	other
CSARDEAGQNTGELFF	other
CASSTRSGQPQHF	other
CAWSEDRNTEAFF	NLVPMVATV
CASSGRTEGDYGYTF	NLVPMVATV
CASSQEPNWNTEAFF	other
CASSPRGGIINEQFF	other
CSVGKGDSPNEKLFF	NLVPMVATV
CASKSTGGTDTQYF	NLVPMVATV
CASSLDSANYGYTF	other
CASSPSGQYYGYTF	NLVPMVATV
CSARDLAAQNTGELFF	other
CASSRETGSGANVLTF	other
CASSFDYTGELFF	NLVPMVATV
CATSRDQGRGQPQHF	other
CASSEGGRVADTQYF	NLVPMVATV
CASNTRSTDTQYF	other
CASSIRATNEQFF	other
CASSQSPGGFQYF	other
CSVLRGPEGDTQYF	NLVPMVATV
CASPPLSGTGHVRGYTF	other
CATQGPSEINTGELFF	other
CASSVRSSYEQHF	other
CASSQETGGAYTEAFF	other
CAVGEANTGELFF	other
CASSGAGGHETQYF	other
CATSDLPGGRETQYF	NLVPMVATV
CASSLGLAGNEQYF	other
CASSFGGNTEAFF	NLVPMVATV
CSALPGLAGSNEQFF	NLVPMVATV
CASSEAGGRGTDTQYF	NLVPMVATV
CASSLEVGGQETQYF	other
CASSPEQGIYEQYF	NLVPMVATV
CASSPRQGARWNTEAFF	other
CASMRWGPPLHF	other
CASSLIQDPGELFF	other
CASSLGTYEQYF	NLVPMVATV
CASSLGQALTDTQYF	NLVPMVATV
CASRGRTGTNEKLFF	NLVPMVATV
CASSGDRGYHEQYF	NLVPMVATV
CASSSGGSNTGELFF	other
CAWARDGTYEQYF	NLVPMVATV
CASSLYRGQGGQPQHF	NLVPMVATV
CASSFHNQETQYF	other
CASSPTTGTESYEQYF	NLVPMVATV
CASSHSGGEQYF	NLVPMVATV
CASSYTGDEQYF	NLVPMVATV
CASSFVGGGEQFF	NLVPMVATV
CASSIDGGDGYTF	NLVPMVATV
CASSPPGGGNTGELFF	other
CSARTSQETQYF	NLVPMVATV
CASKEGGGVYGYTF	NLVPMVATV
CATSDSGTPGNEQFF	other
CASSPSPGVGLYEQYF	other
CASSLFTGGSGYTF	other
CASSFRSGGAPEQFF	other
CASGTGEAYEQYF	other
CASSPRGNYGYTF	NLVPMVATV
CASSSGGRKDTIYF	other
CASSPLGGNEQFF	NLVPMVATV
CSVLWTEAFF	other
CASSPHREDTQYF	other
CSARATGDLAGFTYEQYF	NLVPMVATV
CASSPPRRGAAPDTQYF	other
CASSPHGGGINEQFF	other
CASTRTGLAGGYHNEQFF	NLVPMVATV
CASSLDRGEQFF	NLVPMVATV
CASSIFSGVSYNEQFF	NLVPMVATV
CASSDGDEQFF	NLVPMVATV
CASSTFSNTEAFF	other
CASSIRAADEQYF	other
CASSRGGYNEQFF	other
CASSPGRGTINEKLFF	NLVPMVATV
CASQLRESGNTIYF	NLVPMVATV
CATSDLGGLSYNEQFF	NLVPMVATV
CASSFPGTDTQYF	NLVPMVATV
CSARWRYSRGPDTQYF	other
CSAKRPSSYNEQFF	NLVPMVATV
CSVEEGDYEQYF	NLVPMVATV
CASSKGTTGALQETQYF	other
CASSVGLHGQPTNEKLFF	NLVPMVATV
CASSTRAGVEQYF	other
CASSLAGPNNEQFF	NLVPMVATV
CASSLGQMGNQPQHF	other
CASSLQGLVDTGELFF	NLVPMVATV
CASSMRSSSPLHF	other
CASSFRQGARSNQPQHF	NLVPMVATV
CASSFEGVGNTIYF	NLVPMVATV
CSARDPGGSYNEQFF	NLVPMVATV
CASSLLGTSGPRETQYF	other
CSARDAEGQNTGELFF	other
CASSSRDRAVANYGYTF	NLVPMVATV
CASSLAGTDYTGELFF	NLVPMVATV
CAIRTSGMLNTGELFF	other
CASSLVAWPGTDTQYF	NLVPMVATV
CASSLTPGATNEKLFF	NLVPMVATV
CASTRWVAGGKGDEQFF	NLVPMVATV
CASSEVPGVDTQYF	NLVPMVATV
CASSQDGTGTLRQQYF	NLVPMVATV
CSVDRGSYEQYF	NLVPMVATV
CASSSDSYNEQFF	NLVPMVATV
CASSPLTLDRGLTYEQYF	NLVPMVATV
CASSIPLRGPETSTDTQYF	other
CSVEGRPGHTEAFF	other
CASSMRSSYNEQFF	other
CASGQGAGELFF	NLVPMVATV
CASSIRSAGPLFF	other
CASSFRGPPYEQYF	NLVPMVATV
CASSLIPVSGELFF	NLVPMVATV
CASSSTRGVGQPQHF	NLVPMVATV
CASSYVGLGSPLHF	other
CASSQPSSSYEQYF	other
CASSSPTLSRETQYF	NLVPMVATV
CASSPLGGGKSTEAFF	other
CASSEMNTGELFF	other
CASSTHGGAWQYF	other
CASSQYTGANTEAFF	NLVPMVATV
CASSSSPGGVLTF	NLVPMVATV
CASSTFGGQPQHF	other
CASSIRASWEQYF	other
CASRDTSYEQYF	other
CASSEYVQYYFYTF	other
CASTELNGGTQYF	other
CASSYGKGGELFF	NLVPMVATV
CASSQIGGQGGGNEQFF	other
CASSVYHNNEQFF	NLVPMVATV
CSARVEFGSGELFF	other
CASSVAGRGQETQYF	NLVPMVATV
CASSQDLLAGEQYF	other
CASSLSNDFRGEQYF	NLVPMVATV
CASSWGQMNTGELFF	NLVPMVATV
CASSLDRAEQYF	NLVPMVATV
CSATDRGLSGPEAFF	other
CASSLVGQRISGNTIYF	other
CASSTGQETQYF	other
CASSFPSLNTGELFF	NLVPMVATV
CASSISRGRGYNEQFF	other
CASSQRQGPEYPGELFF	NLVPMVATV
CASSQVHRASGANVLTF	other
CASSYEEEEYNEQFF	NLVPMVATV
CASSEVNEQFF	NLVPMVATV
CASTSLNTGELFF	other
CASNLGGPVDEQFF	NLVPMVATV
CASNPSPGNTGELFF	other
CASSMWVNQPQHF	NLVPMVATV
CASTDRGTVNEKLFF	NLVPMVATV
CASSFAGTDTQYF	other
CASSRRGGMETQYF	NLVPMVATV
CASSIYNNQPQHF	other
CASSLGLYEQYF	NLVPMVATV
CASSYIPSYEQYF	NLVPMVATV
CSARGAREAFF	NLVPMVATV
CSVAGRLSNQPQHF	other
CASSSMLDRHAAQYF	NLVPMVATV
CASSPEETGELFF	NLVPMVATV
CATSDLWFRNNEQFF	NLVPMVATV
CASSTVDPMLSEAFF	other
CATGIGELFF	other
CATSRPVGEYTEAFF	other
CASSQDPLAGGGGEQFF	other
CASSESGSGNEQYF	NLVPMVATV
CSARPVQGINYGYTF	NLVPMVATV
CASSLGGGLYNSPLHF	other
CSARGITGGTGETQYF	NLVPMVATV
CASSLRGSTDTQYF	NLVPMVATV
CASSVGWYGYTF	other
CASSPTGGGSPLHF	other
CASSPGLAGGFSGTDTQYF	other
CAISKTDRGNTEAFF	other
CSARGTIDRDPNSPLHF	NLVPMVATV
CASSSDSYEQYF	other
CSVTRQASTDTQYF	NLVPMVATV
CASSQRSSTEAFF	other
CASSPNSNQPQHF	other
CASSSSLEAFF	NLVPMVATV
CASSQDLVAEAFF	NLVPMVATV
CSATDRGLSYEQYF	NLVPMVATV
CASSDDRGPYEQYF	other
CASSLPKNTPVRGLDNEAFF	other
CASSGVEFYNEQFF	NLVPMVATV
CASSFGQNTGELFF	other
CASSVWTGGYNEQFF	other
CSARLADNEQFF	NLVPMVATV
CATSEPAGLAGGNNEQFF	other
CASSEEGEGTDTQYF	NLVPMVATV
CASSGGTGELFF	NLVPMVATV
CSAIKYDTGELFF	NLVPMVATV
CASSDQNGNIQYF	other
CASSQVSTNEQFF	other
CASSRGAGELFF	NLVPMVATV
CASSEVGVMNTEAFF	other
CASSLRGSHETQYF	NLVPMVATV
CASSLVPGLTYEQYF	other
CASTLGGGTEAFF	other
CASSQEPGYGYTF	NLVPMVATV
CASSLRGQASGYTF	NLVPMVATV
CSVEDGAGGLWYTDTQYF	NLVPMVATV
CASSPGLATDTQYF	other
CASSEQNSNQPQHF	NLVPMVATV
CASSRTGIDEQFF	other
CASSYLYGTGGIEQYF	NLVPMVATV
CASSIRAGDEQFF	other
CATSGRSTDTQYF	other
CSVLTAASGAGVEQYF	NLVPMVATV
CSASPGQGHNSPLHF	NLVPMVATV
CASSQVAGALREQYF	other
CASRTGGYEQYF	other
CSARDLNTEAFF	NLVPMVATV
CAIRSQGAVSHEQFF	other
CASSLAGDHQPQHF	NLVPMVATV
CASSKTQLWETQYF	NLVPMVATV
CASSFTPGDYEQYF	other
CASSLWSSTGELFF	NLVPMVATV
CSASRRGVQMNTEAFF	NLVPMVATV
CASSQDAQGVLKRFF	NLVPMVATV
CATSTTGTSGGLLGELFF	NLVPMVATV
CTSSFGGTQYF	other
CASSLGQGRNEQFF	NLVPMVATV
CATSRDKGTDTQYF	NLVPMVATV
CASSFRSSQPQHF	other
CSAREFGLDSYNEQFF	other
CASSQERGGRYTEAFF	other
CASSLGQGTGELFF	NLVPMVATV
CASSPGQGAYTGELFF	NLVPMVATV
CASSVDSNEQFF	NLVPMVATV
CASSRGTAGETEAFF	other
CSARWGTEAFF	other
CASSYVPGRNNNQPQHF	other
CSVEGAPNTYNEQFF	NLVPMVATV
CSAGTYNSPLHF	other
CASSYEWGGLPKNIQYF	other
CASSFFPNTEAFF	NLVPMVATV
CSVEGTGGAPLYGYTF	NLVPMVATV
CSASRRETQYF	other
CASSLVQGGNTGELFF	other
CASSLDGVLGLNSYNEQFF	NLVPMVATV
CASSLAARGGSYEQYF	other
CSARDLGGLNTEAFF	NLVPMVATV
CASSLGQLGEQFF	NLVPMVATV
CASSSRSSEPQHF	other
CASSVELAGTYEQYF	other
CASRSSYVGLADLPETQYF	NLVPMVATV
CASSSGVGHEAFF	other
CASPSQLRPQETQYF	NLVPMVATV
CASSLGPHDSTNYGYTF	other
CATGHQPQHF	NLVPMVATV
CATAGGTSEYRTDTQYF	NLVPMVATV
CASKDNISFRGYTF	other
CASSLYTGFTNEKLFF	NLVPMVATV
CSAREGWAGYGYTF	other
CASSDGGGTTGELFF	NLVPMVATV
CSVEVNTEAFF	NLVPMVATV
CASSRPTEVLASEQFF	other
CASSLASGELYNEQFF	NLVPMVATV
CASVENTEAFF	other
CASSGHDRVYDTDTQYF	NLVPMVATV
CASEWGSNSNQPQHF	NLVPMVATV
CASSLYGGDNNEQFF	other
CASSLGSGGPDEQYF	other
CASSQVRGASTEAFF	NLVPMVATV
CASSQGSGSTDTQYF	NLVPMVATV
CASRKENQPQHF	NLVPMVATV
CASSSQRADTQYF	NLVPMVATV
CASSIGIHGYTF	other
CASRGREQFF	other
CASSSVRAGATYNEQFF	NLVPMVATV
CASSQDSGEPYNEQFF	other
CSARDVQGWNTEAFF	NLVPMVATV
CASSPTGVGPQHF	other
CASSRTGSDYGYTF	other
CASSFGLNTGELFF	NLVPMVATV
CASSFGSVDTDTQYF	other
CATSGATDRGYLNQPQHF	NLVPMVATV
CASSLWGDEGTDTQYF	other
CASSYSSTEAFF	other
CASSLSTGEFSYEQYF	other
CASSPSDTNTEAFF	other
CASSQDVGVFYEQYF	NLVPMVATV
CASTWKGGGTEAFF	other
CASSFNRGPPLSGANVLTF	other
CASSPSTKYTGELFF	NLVPMVATV
CSVEDLGNEQFF	other
CASSPRGAYQPQHF	NLVPMVATV
CASSQGTHDNQPQHF	NLVPMVATV
CASSLGQGTGKLFF	other
CASRWGAEAFF	other
CSARAKDVAGVDEQFF	NLVPMVATV
CASSYGLNYGYTF	NLVPMVATV
CASSQDGGTYTQYF	NLVPMVATV
CASNNQNTGELFF	other
CASGSGGSDEQFF	other
CASSEGQDFYEQYF	other
CASSLGYGDSPLHF	other
CASSPRATTNEKLFF	NLVPMVATV
CSASEWAGATYEQYF	NLVPMVATV
CASSPGPGTLNLTGWYNEQFF	NLVPMVATV
CSASRRGGTNEKLFF	other
CASSQVILGFGNEQFF	NLVPMVATV
CSAALPYYGYTF	NLVPMVATV
CSARDPVSGQGALLLYDQYF	other
CASNGLGPHTDTQYF	NLVPMVATV
CASSIRSTSEQYF	other
CSVWTAEAFF	other
CATSRDRANYGYTF	NLVPMVATV
CSAIPDRAGADTQYF	NLVPMVATV
CASSRGLDNEQYF	other
CSVVAGAVEAFF	other
CSVLGQGDGEQFF	other
CASSEGGTGYIHEQFF	NLVPMVATV
CASSQVGISYEQYF	other
CASSPLAGPANEQFF	other
CASSLVGAGGGLDTQYF	NLVPMVATV
CASSQLEETNTEAFF	NLVPMVATV
CSAPEAGDYNEQFF	other
CASHPGAGPSYNEQFF	NLVPMVATV
CSVTGTTYEQYF	NLVPMVATV
CASSPAGHTGELFF	other
CASSHEGLGGYTF	NLVPMVATV
CASSREGSGGYTF	NLVPMVATV
CASSQGQNTGELFF	other
CASSIIGVNEQFF	other
CSAQLQLGNEQFF	NLVPMVATV
CASSSRTGYEQYF	NLVPMVATV
CSATTQTLDRRIRTDTQYF	NLVPMVATV
CASSGGPGDNEQFF	NLVPMVATV
CASSPLAGGNTGELFF	other
CASSLHGGLEQYF	other
CASSLYDTNTEAFF	other
CASSSLNTEAFF	other
CASSLWDQPQHF	NLVPMVATV
CASSPGQRTEAFF	other
CASSMLRIVYDTQYF	other
CSARGGLSQNTGELFF	other
CSAKRGNTEAFF	other
CSATLGLAEYNEQFF	NLVPMVATV
CASTPGIYNSPLHF	other
CASSLQGSNSPLHF	NLVPMVATV
CASFGEVQGAVEEQYF	NLVPMVATV
CVSSSVNEQFF	NLVPMVATV
CATSREVETGELFF	NLVPMVATV
CASSLEGDPFYEQYF	NLVPMVATV
CASSIGEYGYTF	other
CASSLDGTPFYEQYF	other
CASSLEHEQYF	other
CASSQYRGGGETQYF	other
CASSQVGYYGYTF	NLVPMVATV
CASSQLDTQYEQYF	NLVPMVATV
CASSKRATSTDTQYF	other
CASSSQGGLNEQFF	NLVPMVATV
CASTPLAGDTDTQYF	other
CASSIYSANEQFF	other
CSARGFAGGTDLEQFF	other
CATNDPIRASSHEQFF	other
CSVEDGRDTGEGTDTQYF	other
CASSLSSHTGELFF	NLVPMVATV
CASRPFSGSPYEQYF	NLVPMVATV
CASSLFSAGGREQYF	other
CASRLGPEAFF	NLVPMVATV
CASSDSEGGYYEQYF	other
CSGGQARYEQFF	other
CSGGQGDGYTF	other
CASSLYSEVSGDEQYF	NLVPMVATV
CASSWIPGGSEAFF	NLVPMVATV
CASSPGQGVNTEAFF	NLVPMVATV
CSARDAPSRGGTNEKLFF	other
CASSIRSGESTQYF	other
CAITDLNTGELFF	other
CAWSVGDWETQYF	NLVPMVATV
CASSPGTGGDNEQFF	NLVPMVATV
CSVAFRDVSSYEQYF	other
CASSGRSSDTQYF	other
CASSGGPPAREQYF	other
CASSIFGGAGNQPQHF	other
CASSQGGDRGDPGDGYTF	other
CASSQDGTGSGPQHF	NLVPMVATV
CASSLGDQPQHF	NLVPMVATV
CASSEAGTGNTIYF	other
CASSQEETGLSEKLFF	NLVPMVATV
CASSLGRGLGAAFF	NLVPMVATV
CASRGGAELNTGELFF	other
CASSLGRVLSEAFF	other
CASSQAEKTGELFF	NLVPMVATV
CSVARPEGVADTQYF	other
CATPGNYEQYF	other
CASTFRGANNEQFF	other
CASMGNSAGANVLTF	NLVPMVATV
CASSLELAGAQETQYF	NLVPMVATV
CASSTIVGENTEAFF	other
CASSLAQGTDTQYF	NLVPMVATV
CASSSAGVLNQPQHF	NLVPMVATV
CATRRGTEAFF	other
CSASPRGGEQYF	other
CASSFYFTGAPYYEQFF	NLVPMVATV
CASSVEGIDEKLFF	other
CASSDSVSFLNQPQHF	NLVPMVATV
CSARDWEQMNTGELFF	other
CSSSLWDRSSGANVLTF	NLVPMVATV
CASSFRGDTEAFF	other
CSALAGAFYEQYF	other
CASKWGGRAVLNTEAFF	other
CASSPLTSTDTQYF	NLVPMVATV
CAWSGQLHYGYTF	NLVPMVATV
CASSPGPSYGYTF	other
CASLGQQGRDYGYTF	other
CASSLPDGEAFF	NLVPMVATV
CSASWEASDEQYF	other
CASSQGYGVLGTEAFF	other
CASSLTATDTQYF	other
CASSYIDRVYNSPLHF	other
CASSIISGSYNEQFF	other
CASSLGLDTDTQYF	other
CASSLGGSEAFF	NLVPMVATV
CASSAGGMNTEAFF	other
CASSWTQETQYF	other
CSARDGPGVNTGELFF	other
CSVGGGGQPQHF	NLVPMVATV
CASSPDIEQFF	other
CASSILAYYGYTF	other
CALGDLNTGELFF	other
CASSQLTATNYGYTF	other
CASTGVGGFGGANVLTF	other
CAGGRGNTGELFF	other
CASSFGAGADTQYF	other
CASSQVERGGVETQYF	NLVPMVATV
CASSWGGGQVPYEQYF	other
CASSSVPAPHQETQYF	NLVPMVATV
CATKGTESNQPQHF	NLVPMVATV
CASSEWGADNYGYTF	other
CASSVALGMNTEAFF	other
CASSFGGTEFF	NLVPMVATV
CASSPIGGGGNEQFF	other
CASSWTSGGSDTQYF	NLVPMVATV
CASSLIRSGEQYF	NLVPMVATV
CASSLLASGSSYNEQFF	NLVPMVATV
CASSLGGSTEAFF	NLVPMVATV
CASSLSRPYPETQYF	other
CASSKNGQGANPFGELFF	other
CASSLKGANYGYTF	NLVPMVATV
CASSLETQYF	NLVPMVATV
CASSIVPTYEQYF	NLVPMVATV
CASSEYVRGGNTIYF	other
CASSIRRNGGTEAFF	other
CASSFGQGADIQYF	other
CASRDRGYNQPQHF	NLVPMVATV
CASSLGGNTGELFF	other
CASSPTGIGTYEQYF	other
CASSDWGGTGRGPEAFF	other
CASSIHFSAGQPQHF	other
CASSANKVSGGPDNEQFF	other
CASSKGTANTEAFF	NLVPMVATV
CASSLERGGRDTQYF	other
CSVEGEGGSYNEQFF	NLVPMVATV
CATSTGAYGYTF	other
CASSPLLEGHQPQHF	other
CATSRSRAGAYEQYF	other
CASGEGNTGELFF	other
CASSPGPGLNQPQHF	other
CASSSDVLPEQYF	NLVPMVATV
CSARDQPGQNTGELFF	other
CSAKDGISGELFF	NLVPMVATV
CASSRRSADTQYF	other
CASSLGGTTEAFF	NLVPMVATV
CSVAGQPSGANVLTF	NLVPMVATV
CASSMYLFETQYF	other
CASSIRSTDTRYF	other
CSVEDSYYEQYF	NLVPMVATV
CASIGLESYEQYF	NLVPMVATV
CATGSANTGELFF	other
CASSPGGAQETQYF	NLVPMVATV
CATSPTGGTHNEQFF	other
CASSFFPPSNSPLHF	other
CASQGLAGLNEQFF	other
CASSPVEDEQFF	NLVPMVATV
CASSIFGNGYTF	other
CASSQPGSYEQYF	NLVPMVATV
CASSYNRTPGQGYTQYF	other
CASSYHRGQDVIGEQFF	other
CSASGHHYGYTF	NLVPMVATV
CASSPRVQETQYF	NLVPMVATV
CASSYQTGDTGELFF	NLVPMVATV
CASSYCPELAKNIQYF	other
CASSQVFGENTEAFF	other
CASSYGPEAFF	other
CASSSTGMFGEQYF	other
CSPRTTSF	NLVPMVATV
CSAAQTGTVNTEAFF	other
CASSPVGGDNEQFF	NLVPMVATV
CSARAEGGELFF	other
CASSPGLVDRVVGETQYF	NLVPMVATV
CASSPQRRLAGGDTQYF	other
CASSFAYGYTF	other
CSARARAGGYEQYF	NLVPMVATV
CASSYSKGPSSGANVLTF	NLVPMVATV
CASSMHGASELYF	other
CASSLEASGSGETQYF	NLVPMVATV
CASSETYTSGPNTGELFF	other
CASSTYNEQFF	other
CASSSLNGAVNTGELFF	NLVPMVATV
CSARTGGTDTQYF	NLVPMVATV
CASSLVGVNTEAFF	NLVPMVATV
CASSPVATSYNEQFF	NLVPMVATV
CASSQSYEQYF	NLVPMVATV
CAWSVGPGYTEAFF	NLVPMVATV
CASSYPGLANEQFF	NLVPMVATV
CASSIYSLNEQFF	other
CAISGLAGVDTQYF	NLVPMVATV
CASSPSGLTHNEQFF	other
CASSIRGAGEQFF	other
CATSSLNQPQHF	NLVPMVATV
CAISEGTNTGELFF	NLVPMVATV
CSARDLDRADNTGELFF	NLVPMVATV
CASSKGKLPPGYGYTF	other
CASGTGANEKLFF	other
CASSKGQANTGELFF	NLVPMVATV
CASSIAGDEQFF	other
CASGLVLSDEQFF	other
CASTRGTSGQETQYF	NLVPMVATV
CASSPTEIMNTEAFF	other
CASSIMAGEYNEQFF	other
CATERGGSDTQYF	other
CASSEGADTGELFF	other
CVSSVRSSYEQYF	other
CASSLIGTGYTGELFF	NLVPMVATV
CASSLAGYTEAFF	other
CASSIFGGQNQPQHF	NLVPMVATV
CASSQEVSAGLREGYTF	NLVPMVATV
CASSFYFAGAPYNEQFF	NLVPMVATV
CASSIGVNTEAFF	other
CAWSMGGSAGYTF	NLVPMVATV
CASKMEAGLSYEQYF	NLVPMVATV
CASSLARVTGELFF	NLVPMVATV
CASSESTGTAYGYTF	NLVPMVATV
CASSDAGSYEQYF	NLVPMVATV
CASTGGPLGEQFF	other
CASTSGTGLSNQPQHF	NLVPMVATV
CASSYSMDSSYEQYF	other
CASSSGLAGEQFF	NLVPMVATV
CSVVDSKNTEAFF	NLVPMVATV
CASSFLGGEGSTLNTGELFF	other
CASRVGPEAFF	NLVPMVATV
CASSLAGTPTDTQYF	NLVPMVATV
CASSPTGSLNEQFF	other
CASSQGFGNTEAFF	other
CARALFGNTIYF	other
CASSGYSNQPQHF	other
CASSRMVVAGVGTDTQYF	NLVPMVATV
CASSIEGLAEYNEQFF	other
CASRAGGAGTDTQYF	other
CASSSRSGNIQYF	other
CASSKRASYEQYF	other
CASTPEKSLGPGTQYF	NLVPMVATV
CASSLSGTGELFF	other
CASSQEGGGYNEQFF	NLVPMVATV
CASSSSSGETQYF	other
CASRGLSAFF	other
CATSRSTGGLNQPQHF	NLVPMVATV
CASSFRSGVEQYF	other
CASSLESDYNSPLHF	other
CASSLSGDTGELFF	NLVPMVATV
CATRPGANTGELFF	NLVPMVATV
CASSLDLGRYEQYF	other
CSARTGFGGAEETQYF	NLVPMVATV
CASSTHLGSGNTIYF	other
CSARGDRSYEQYF	NLVPMVATV
CATSRSGLSGNTIYF	other
CASSLPGTFLGGCGNQPQHF	NLVPMVATV
CAWGTGQGVIYNEQFF	other
CASSQDGLAGAHTDTQYF	NLVPMVATV
CASSLVGTGFLDEQFF	other
CAWSGGLAGGFSYNEQFF	NLVPMVATV
CSAPGGGLTDTQYF	NLVPMVATV
CASSPPSAGPGEQYF	NLVPMVATV
CATSSSGLGAEQYF	other
CASASPGASGGAGQNTGELFF	NLVPMVATV
CASSFWDTWTETQYF	other
CASSPGRENTEAFF	NLVPMVATV
CASGTGSNQPQHF	other
CASSLGGGQGEGELFF	NLVPMVATV
CARGLADTGELFF	other
CASSSGTSGNGATDTQYF	NLVPMVATV
CASSYGFYEQYF	other
CAIADANTGELFF	other
CASSSAGMGQPQHF	NLVPMVATV
CASSVRAAYEQYF	other
CASSLVGEGDQPQHF	other
CAGSIYSNQPQHF	other
CASSPGQGTEAFF	other
CASSLSSRVGYEQYF	other
CASSTGGEVETQYF	other
CASSVETSGRLNEQFF	NLVPMVATV
CASKGVGYTF	NLVPMVATV
CATLKQGAMDWETQYF	NLVPMVATV
CASSMLGEGAGTEAFF	NLVPMVATV
CSASRQGYYNEQFF	NLVPMVATV
CASSVRSTDMQYF	other
CSARDRLAQNTGELFF	other
CASSLDPSLFATDTQYF	NLVPMVATV
CASSSDIEAFF	other
CSVGGWQGYNEQFF	other
CASSGDRPRYEQYF	NLVPMVATV
CASSDGTGGDSTQYF	NLVPMVATV
CASSLGPLDEQYF	other
CASSFGQGADEAFF	other
CASSRGAGAGTDTQYF	other
CSGQGAFGSGELFF	other
CATSSPRGEGGSPLHF	other
CSLQGKGGANVLTF	other
CASSLVGGGMGWEQLF	NLVPMVATV
CASSLASLGLALSSYEQYF	other
CASSLTGGLRYTEAFF	NLVPMVATV
CASGVLAEDTIYF	other
CATTTGTGGFDEQFF	other
CASSLARGGTEAFF	other
CASSQTGGTEAFF	other
CASSLGLASGSNEQFF	other
CASSDSDNNEQFF	other
CASSFSTAGRETQYF	other
CASLTPGRQTEAFF	other
CASNNLNTGELFF	other
CASRAVSTDTQYF	other
CASSMTGGTYGYTF	other
CASSSMGYQPQHF	other
CASSFRSSTEAFF	other
CASSLEPGTGETQYF	other
CASSLGETQYF	NLVPMVATV
CASNKGRYSGANVLTF	other
CTSSEDHTGFYEQYF	NLVPMVATV
CASSGRSGVEQFF	other
CASSSTGVPNEKLFF	other
CASSLTSVNEQFF	other
CASSGETDTQYF	other
CASSPTGDNTGELFF	NLVPMVATV
CASSLVQASENEQYF	other
CASSIRSSHEQFF	other
CAWTTSPRGSDTQYF	NLVPMVATV
CATSDRPGGEQYF	NLVPMVATV
CASSHPIDVSSYNEQFF	NLVPMVATV
CASSMTSGSEQYF	other
CASSQEKGATQSHNTEAFF	other
CAIEGGQSYEQYF	other
CASSHPGGQPQHF	NLVPMVATV
CASSFVAVGNTIYF	other
CASGSGTLNEQFF	NLVPMVATV
CASSKSQDNYGYTF	other
CASSPAEGQRGEKLFF	other
CASSPEDTQYF	other
CASSPGQGYEQYF	NLVPMVATV
CSVPGQTNTEAFF	NLVPMVATV
CASAGFSVNEQFF	other
CASGLPQGRGEQFF	NLVPMVATV
CASSFDRAVYEQYF	NLVPMVATV
CASSLGVWGGEQFF	NLVPMVATV
CASSLFPSGMDHEQYF	other
CASSIAAGASNYGYTF	NLVPMVATV
CASSLAELDGNTIYF	other
CARRSWGASEQFF	other
CASSPRTSGGATDTQYF	other
CASSKYDSPLECEQYF	NLVPMVATV
CSVDQGAGGYDGYTF	other
CSSSQEEGPGNQPQHF	NLVPMVATV
CAWSINSAEAFF	other
CASSNRAADTQYF	other
CSGKQDTSWTDTQYF	NLVPMVATV
CASSIRAASPQHF	other
CASSQDRVVNEQFF	NLVPMVATV
CASSTAAYEQYF	NLVPMVATV
CASSPGGRTDNPHTDTQYF	NLVPMVATV
CASSPFLTGSNTEAFF	other
CASSVALGLNYEQYF	other
CASSLFLGGANVLTF	NLVPMVATV
CSARDVAGGSLKQYF	NLVPMVATV
CASSLGGGGSPLHF	other
CASSQVASGNTEAFF	other
CASSFGTGRAGYTF	other
CASSQEGAEAPYNEQFF	other
CSARQGSGNTIYF	NLVPMVATV
CASSLEAADNYGYTF	other
CASSSSRASKSYNEQFF	NLVPMVATV
