CDR3b	label
CASSLDWVSYEQYF	False
CASSSGGSQNTLYF	False
CASSLGLGTNTGQLYF	False
CASSETGTNSDYTF	False
CGAREGFEQYF	True
CGARDQQGTNERLFF	False
CASAGGQNTLYF	False
CASSYWGENGQLYF	True
CASSDFANTEVFF	False
CASSLSRTANQAPLF	False
CASSLDEGSEQYF	False
CASSQDLISYEQYF	False
CASSPGHSQNTLYF	False
CASSQDTGEEQYF	False
CASSRLGASQNTLYF	False
CASSPDRGRTEVFF	False
CASSLDTGQEQYF	False
CASSWTGGSTYEQYF	False
CASSFDRFSQNTLYF	False
CASGDAAGVTGQLYF	False
CASSFTINQDTQYF	True
CTCSAVGQGAETLYF	True
CASSLGLGAYEQYF	False
CASSLTGSQNTLYF	False
CSSRARAANERLFF	False
CGARVGTANTEVFF	False
CASSPGTGSAEQFF	False
CASSPGTTANTEVFF	False
CASSTGGDTQYF	False
CASSQRTGDGQLYF	False
CASSDRLGVYAEQFF	False
CASRYANSDYTF	False
CASSGDRSQNTLYF	False
CASSLLGGRGQDTQYF	True
CASSIGNSQNTLYF	True
CASSGTANSDYTF	False
CASSSGLGASAETLYF	False
CASGDAGVAETLYF	False
CASSPFRSYEQYF	False
CGAREGGSAEQFF	False
CASSPRDWTAEQFF	False
CASSDASGWEQYF	False
CASKTGLEQYF	False
CASSWGNERLFF	False
CASSDHTNTEVFF	True
CASSLDSNERLFF	False
CASSLLDTNERLFF	False
CASSRAQYTEVFF	True
CASSLGGNQDTQYF	False
CTCSADYRGEQYF	False
CASSPGEYAEQFF	False
CASSRLGGEGYEQYF	False
CASSDKIGVTEVFF	False
CASSSGNYAEQFF	True
CAWSLGPGQGSTGQLYF	False
CASSPGLGTEQFF	False
CASSPGLGVGAETLYF	True
CASSLGGISNERLFF	False
CASSGTVGQNTLYF	False
CASSDAGGAREQYF	True
CTCSETTNTEVFF	False
CASSMEGQGAEQFF	False
CASSGLGGNQDTQYF	False
CASSIPNNQDTQYF	False
CASSSHPSYEQYF	False
CASSSGTGGAERLFF	False
CASSDIYEQYF	False
CASSPREVYF	False
CASSQDWGLSGNTLYF	False
CASSFNRGNYAEQFF	False
CASSLGTGTEVFF	False
CASSPLRDRGDTQYF	False
CASSIGTGGQNTLYF	False
CASSLYNSPLYF	False
CASSDWGGSETLYF	False
CASSLDRGRDTGQLYF	False
CASSLTGTNTEVFF	False
CASSPRGRNTLYF	False
CASSLDGPSQNTLYF	False
CTCSASQDNYAEQFF	False
CASGDRGEGSQNTLYF	False
CASRSTGGNTEVFF	True
CASSLDWGGQNTLYF	False
CGARDSPGTYEQYF	False
CASSIGTGVTGQLYF	False
CASSPDFSYEQYF	False
CASSLASNERLFF	False
CASSDWGGEDTQYF	False
CASNGVNQDTQYF	True
CASSPTNYAEQFF	False
CASSLTEQYF	False
CASSIAGRDQAPLF	False
CASSRDIYAEQFF	False
CASSFGVAETLYF	False
CASRTGGAQDTQYF	False
CASSPKNTEVFF	False
CASSRDRGYNSPLYF	False
CASGGGREVFF	False
CASSLQGRNSPLYF	False
CASSRGDNYAEQFF	False
CASSQDGGGRGEQYF	False
CAWSGAGRGSDYTF	False
CTCSGGLAYEQYF	False
CASSQELDWGYEQYF	False
CASSPYERLFF	False
CASSPGQGNTGQLYF	False
CASSPGQGFEQFF	False
CASRTGTGGGAETLYF	False
CASSDWGGREQNTLYF	True
CASSLDWGINQDTQYF	False
CASRQGADTEVFF	False
CASSLAQLGGHAEQFF	False
CASSRTTNSDYTF	False
CASSLGLGGRYAEQFF	False
CASSDAGGGNERLFF	False
CASSTGTGNQAPLF	False
CASSLVADNYAEQFF	False
CASSTTGGEQYF	False
CASGDAQNTEVFF	False
CASSLRLGGYAEQFF	False
CASGDARGRVAEQFF	False
CASSGPGGSSYEQYF	False
CASGGGTSLYAEQFF	False
CGANGQGAAEQFF	False
CTCSADRNNSPLYF	False
CASSFPGAETLYF	False
CASSYPRTGGNQDTQYF	False
CASSDF	False
CASSQDTGRNSDYTF	False
CASSDPGGDAETLYF	False
CASSDWGAQNTLYF	False
CASSDWENTEVFF	True
CASSLGGQDTQYF	False
CASRGRDERLFF	False
CASSLMQNYAEQFF	False
CASSSQGANSDYTF	False
CASSPLGDNYAEQFF	False
CGARDRTNSNERLFF	False
CASSLRDRGGEQYF	False
CASSFGGRAETLYF	False
CASSDARGRNSPLYF	True
CASSRDNQAPLF	False
CASSMEGAANERLFF	False
CASSDAGGDNERLFF	False
CASGDVWVTNTGQLYF	False
CASGDAYEQYF	False
CASSVGLGGYEQYF	False
CASSQEPDIYEQYF	False
CASSLEAYEQYF	False
CASSLETGVYEQYF	False
CASSLRDWGVQDTQYF	False
CASGDTGTGGAQSAETLYF	False
CASSQTGEQYF	False
CTCSAARANTEVFF	False
CASSLEGGGENSPLYF	False
CASSYGGQDTQYF	False
CASSLEASAETLYF	False
CASSYTGANTEVFF	False
CASSGGLGGFYEQYF	False
CASRQRGASAETLYF	False
CASSLGTDYAEQFF	False
CASSIGGAEAEQFF	True
CASSLDPQGTGGEETLYF	False
CSSSRGQGTYEQYF	False
CASSGDGERLFF	False
CTCSAAINNQAPLF	False
CASRTGGPQDTQYF	False
CASRRLGGRSTYEQYF	False
CASSRGERDTQYF	False
CASSLTQAEVFF	False
CASSDNSNTEVFF	True
CGARDWESSYEQYF	True
CASGDRANTEVFF	False
CASGPGLGGSYEQYF	False
CASSIYNNNQAPLF	False
CASRHAANSDYTF	False
CASGDAAGAETLYF	False
CAWSSRAGNERLFF	False
CASSRLGGREQYF	False
CASSEGENTEVFF	False
CASSLWDNQAPLF	True
CASSLWGAGNTLYF	False
CASTRTGNTEVFF	False
CASSRTGPANSDYTF	True
CASSLGTANSDYTF	False
CAWSLDRARSDYTF	False
CASSIRDRDAEQFF	False
CASRSNSYNSPLYF	False
CASSDEGQGRNSDYTF	False
CGAREAGNNERLFF	False
CASSMTGEDTQYF	False
CASGDLPGGNQDTQYF	True
CASTHRGQGERLFF	False
CASSHWGGGQNTLYF	True
CTCRNRGQDYAEQFF	False
CASSLGNYNSPLYF	False
CASRDTYEQYF	False
CASSLGISNERLFF	True
CASSLDRGWEQYF	False
CASSQGANTGQLYF	False
CASSDTGGHQDTQYF	False
CTCSADIGQTYEQYF	False
CASSQEQDWGSEQYF	False
CASSIWQGAAETLYF	True
CASSADNSDYTF	False
CASSDHSNTEVFF	True
CASVPGTGGYEQYF	False
CASQRGTGQLYF	False
CASSSRGNTLYF	False
CASIRDRGRPEVFF	False
CASSDARNYEQYF	False
CASSLDWGNTGQLYF	False
CASSSRQNTEVFF	False
CASSLTDTQYF	True
CASSLAGDSYEQYF	False
CASRSGTGASYEQYF	False
CASSDSQKYAEQFF	False
CASSSGLGGEQYF	False
CGAREGGYAEQFF	False
CASSFLGGNYAEQFF	True
CASSLSANTGQLYF	True
CASSTPNTEVFF	True
CASSLGGGDTEVFF	True
CASSDYRDEQYF	False
CASSLEGAAFNERLFF	False
CASSSAGHTGQLYF	False
CASTDWASAETLYF	True
CASSSGTGFYEQYF	False
CASSLEQGNTEVFF	False
CASGLSGNTLYF	False
CASRPGQAAETLYF	False
CASSLTINQDTQYF	True
CASSMGRSQNTLYF	True
CASSLNRDEQYF	False
CASSLTGPNERLFF	False
CASSSRTSNTEVFF	False
CASGDRGYSDYTF	False
CASSLGTGNSDYTF	False
CASSETGHYEQYF	False
CASSLGTGIYEQYF	False
CASSEGTSAETLYF	False
CASSLQGSSGNTLYF	False
CASSSPGTGGTLYF	False
CASGGGDKSNSDYTF	False
CASGEGWGGNAEQFF	False
CASSSPGLGYEQYF	False
CASSQDPGGVSAETLYF	False
CASSSGGQDTQYF	False
CASGDMGVNTLYF	False
CASSDWGQDSGNTLYF	False
CASSRDWGSQNTLYF	False
CASSERGKGTGQLYF	False
CTCSAEPKDTQYF	False
CASGGGTGAQDTQYF	False
CASSSAISNERLFF	True
CASSPTGVQDTQYF	False
CASSRLGGANTGQLYF	False
CGARDLDTSYEQYF	False
CASSLSYEQYF	True
CASLRGDNQAPLF	False
CASSFWGGGEQYF	True
CASRNRGGDTQYF	False
CASSPRPGVDTEVFF	False
CTCSARTGGNQAPLF	False
CGARTSNERLFF	False
CTCSPDSPFNYAEQFF	False
CASSPGQGANERLFF	False
CASSHRDWGKNTLYF	False
CTCSAGSSAETLYF	False
CASSLLGGGAETLYF	False
CASGEGTLYF	False
CASGEGASNTGQLYF	True
CASSLRGGDEQYF	False
CASSFLDNANTEVFF	False
CASSLEDRGNAETLYF	False
CASSDLGGRDAEQFF	False
CASSPRLGGNNYAEQFF	False
CASIHLGGGTGQLYF	False
CASSPKDTQYF	False
CASSLDRTASAETLYF	False
CTCSVQNTLYF	False
CASSNRESSYEQYF	False
CASRTGGGYYEQYF	False
CASRDWGAYEQYF	False
CASSLSQGGDTQYF	False
CASSRQGNYAEQFF	False
CASSDHRNTEVFF	True
CASSLLGGRDTQYF	False
CSSSQSAQISNERLFF	False
CASSLIYEQYF	False
CASGDTGGVEQYF	False
CASSYSGFQDTQYF	True
CASSTGGRDTQYF	False
CASSYGTLISNERLFF	False
CASSFTGLQDTQYF	False
CASSLGVPGQLYF	False
CASSQDWGVGAETLYF	False
CASSLGGRDTQYF	False
CASSLDDRGYAEQFF	True
CASSLGTGGASQNTLYF	False
CASSIWGGAGAETLYF	False
CASSQRDWGDEQYF	False
CASRPGEGNQAPLF	False
CAWRTGGTEVFF	False
CASSAGYQDTQYF	False
CASSFWGEDTQYF	False
CASSAWGGQDTQYF	False
CASSQGLGVEQYF	False
CASSPSTGYAEQFF	True
CASSPGRNNQAPLF	False
CASSIRGGGNTLYF	False
CTCSAPGQANTEVFF	False
CASSLDWGAEQFF	True
CASGDAGGAHAEQFF	False
CASSLYAFEQYF	False
CASSQGHSNTEVFF	False
CASGPGLGDTQYF	False
CASSLPGGYEQYF	True
CASSEGTGQLYF	False
CASSPRTGFSAETLYF	False
CASGYEQYF	True
CASGDALGGPQNTLYF	False
CASSSTINQDTQYF	True
CASSIAKNQAPLF	False
CASSSSRTNYAEQFF	False
CASSDGTGVFQNTLYF	False
CASSQGTEQFF	False
CASSLEQGNYAEQFF	False
CASRPRAETLYF	False
CASSQETGGAWDTQYF	True
CASRQQGSGNTLYF	False
CASSSTGDNTEVFF	False
CASGERGQQYF	False
CASSIQGRNSPLYF	False
CASGDDWGTYEQYF	False
CASSLAGGGTEVFF	False
CASSPTTSAETLYF	False
CASKTGADTEVFF	True
CASSTNTYEQYF	False
CASSAQGANSDYTF	False
CASGDMGESSYEQYF	False
CTCSADRANTEVFF	False
CASGDVGGLDTLYF	False
CASSESWGGEQYF	False
CASRRTGNNQDTQYF	False
CASSQRDWGYEQYF	False
CASSWDNLYEQYF	False
CASGDAEGAERLFF	False
CASSIPGLRAETLYF	False
CASSPTGGSYEQYF	False
CASSDWQSGNTLYF	False
CSSRGRGAETLYF	False
CASRGLGVYAEQFF	False
CASYGGGNTEVFF	False
CASGEGQTEVFF	False
CASSAGTANTEVFF	False
CASSDAGTVTYEQYF	False
CASSSRDSYEQYF	False
CASGGTGSYAEQFF	False
CASSPDWGVSYEQYF	False
CASSDARDWGLEQYF	False
CASSFQGGNQAPLF	False
CASSGLGGSQNTLYF	False
CASSLDLGGRGEQYF	False
CASSDTSANTEVFF	True
CASSFLLGGINQDTQYF	False
CASSGTGASAETLYF	False
CASGDATDQDTQYF	False
CASSLRGGQLYF	False
CASSDEGLNTEVFF	False
CASGDANTEVFF	False
CASSNRQANTGQLYF	True
CTCSGQGANTEVFF	False
CASSLRGGNTEVFF	False
CASSQDLGDTLYF	False
CASSPRDIYAEQFF	False
CASSEWGASAEQFF	False
CASSLRVEQYF	False
CASSMRGQDTQYF	False
CASRVRGNTEVFF	False
CASSPFHTEVFF	False
CASRTGSNSDYTF	False
CASGDRGQGYEQYF	False
CASPPAGEDERLFF	False
CASSDRAAGQLYF	False
CASSLRNERLFF	False
CTCSADLNTEVFF	False
CASSLRTGTYEQYF	False
CASRTGGDQDTQYF	False
CASSAGTFNQAPLF	False
CASSLALGGLSQNTLYF	False
CASSPDWGVQNTLYF	False
CASSLAGSYEQYF	False
CASGDAIGSERLFF	True
CASSHRDRNERLFF	True
CASSGQGAYTEVFF	False
CASSRDWGGSYEQYF	False
CASSQRQTEVFF	False
CGARDRDRENTLYF	False
CASSEKVFSNERLFF	False
CASSDARANSDYTF	False
CASSGTGGVSYEQYF	False
CASSLDGWGGDQDTQYF	False
CASSPRGITGQLYF	False
CASSDEEGRYAEQFF	True
CASHRDFNYAEQFF	False
CASSFRDSLQAPLF	False
CASNRGNTLYF	False
CASSLIRTGGYEQYF	False
CASSLEQNERLFF	True
CASSQEQQDTQYF	False
CTCSDWGGAYEQYF	False
CASSDWGNTEVFF	True
CAWSPYRGEVFF	False
CTCSGGLGLSQNTLYF	True
CASSISGRTGQLYF	True
CASSLGLFYAEQFF	False
CASTFDRADTQYF	True
CASGHRISNERLFF	False
CASSLEGWGNYEQYF	False
CASGVSGTGGSEQYF	False
CASGDRDRGAYEQYF	True
CGAETGSSYEQYF	False
CASSISGQGWTNERLFF	False
CASSQVRNQDTQYF	False
CASSLSGPGNTLYF	False
CASSTGFDNSPLYF	False
CASGTGGNERLFF	False
CASSWTGEEQYF	False
CASSDRGPNERLFF	False
CASSLRDRGTNTEVFF	False
CASSSPGTRNTGQLYF	True
CASGDDWGQDTQYF	False
CASSHDRDEQYF	False
CASGDLGGLAEQFF	False
CASSLGQGSEQYF	False
CASSIVRNTEVFF	False
CASSDSGAGAEQFF	True
CASSLGTGQDTQYF	False
CSSSQTGGARENTLYF	False
CASRDRGFNYAEQFF	False
CTCSAGISNERLFF	False
CASSDATGGIYEQYF	False
CASSTGSGNTLYF	False
CASSPERGDTEVFF	False
CASSPDWGGNYAEQFF	False
CASSSRTGEQYF	False
CASSANYAEQFF	False
CASSSGISNERLFF	False
CASSGTGGRNTLYF	False
CASGVEQGRNQAPLF	False
CASSRDPLGGKDTQYF	False
CASSRDWGYEQYF	False
CASSPGQYNSPLYF	True
CASSQVGTGFYNSPLYF	False
CASRDRGRNSPLYF	True
CASSPGTGGYEQYF	False
CASSHRDNSNERLFF	False
CASSQDWGIYEQYF	False
CASSIWTTSAETLYF	True
CASSTGTTNSDYTF	False
CGARVGGIDTQYF	False
CASSFSTVYEQYF	True
CASGRDNANSDYTF	False
CGARGGVEVFF	False
CASSQEPISGNTLYF	False
CASSFLLGGQEQYF	False
CASSLIQGDEQYF	False
CASSDPGETNTGQLYF	False
CASSPGVNYAEQFF	False
CASSDVGGKDTGQLYF	False
CTCNGGLSGNTLYF	False
CASSPTGVGETLYF	False
CASSLKGSGNTLYF	False
CASSDTGAYAEQFF	True
CASSLITGYEQYF	True
CASSPSWGSSYEQYF	False
CASSLGTGEIVNQAPLF	False
CASSPTGGAQDTQYF	False
CASSQDLGGLGQNTLYF	True
CASSPDWGPYEQYF	False
CASSLDPSQNTLYF	False
CASSRLGNTLYF	False
CASGEPGQNTGQLYF	False
CASSLVAGGRGSPLYF	False
CASSHRGDYAEQFF	False
CASSLEQSNERLFF	False
CASSQEDWGGYEQYF	False
CASSLYRGNSDYTF	False
CASGDRGGGNYAEQFF	False
CASRQGNSGNTLYF	False
CGARAQSNTEVFF	False
CASSLDNSGNTLYF	True
CASSVGQYEQYF	False
CASRHWGAQNTLYF	False
CASSATDANTGQLYF	False
CASSDRVQDTQYF	False
CASSDDGTTNERLFF	False
CGARDWGVAEQFF	False
CASSDTNSDYTF	True
CASSVGQYNNQAPLF	False
CASSPGLGENTLYF	False
CASRTNQDTQYF	False
CASSRDRTTNTEVFF	False
CASSQEQGSYNSPLYF	False
CASSHRDRVYNSPLYF	False
CASSRLTYAEQFF	False
CASSVDWGSSSYEQYF	False
CASSQGQGANSDYTF	False
CASGDWGLGQDTQYF	False
CASGDALGGRDTQYF	False
CASSESYEQYF	False
CASSSTDNTEVFF	False
CASSWGGAGEQYF	False
CASSLFRDYEQYF	True
CASSFLLGSSYEQYF	False
CASSSTGVGDTQYF	False
CASGEGTGGYEQYF	False
CASSQGADTQYF	False
CASSSGLGAEQYF	False
CASSDVRDANTEVFF	False
CAWTGGCAEQFF	False
CASGDRDKLNYAEQFF	False
CASSSDWGGNTGQLYF	False
CASSTGGSNTEVFF	False
CASLRDRTNNQAPLF	True
CASSLTAETLYF	False
CASRWGNSQNTLYF	False
CASSTDRAEQFF	False
CASRDSAETLYF	False
CASSDHQNTEVFF	True
CASSHRGDTQYF	False
CASSRVRGNTEVFF	True
CASSDWGGYEQYF	False
CASAGLGGGWGAETLYF	False
CTCSAGDRNTGQLYF	False
CASSGTSSYNSPLYF	False
CASSLGGQNTLYF	False
CASSQDLGAETLYF	False
CASSTGVSGNTLYF	False
CTCSAGTGDTEVFF	False
CASSSDNYAEQFF	False
CASSIAGGGQNTLYF	False
CASSLGWGGDYEQYF	False
CASGDRTGGSYEQYF	False
CASSDPGGNQAPLF	False
CASSGTGVEQYF	False
CASSFPGNYAEQFF	False
CASSDWGGATGQLYF	False
CASSLSSGGAFEQYF	True
CASGDAQAETLYF	True
CASSAKEQFF	False
CASSTGANTLYF	False
CASSLTGGYEQYF	False
CASSRDWGGAGDEQYF	True
CASSVHRGNSDYTF	False
CASSLKFSDYTF	False
CSSSRGGGQDTQYF	False
CASSVGTGNERLFF	False
CASSLWGGNTEVFF	False
CASSMYRYEQYF	False
CASSPTGGSSYEQYF	False
CASSLSAETLYF	False
CASSPDRGQGEQYF	False
CASSAGTGGYEQYF	False
CASSSSGGLTEVFF	False
CASSLARANTEVFF	False
CASGTGDAEQFF	True
CASGDAWDTEVFF	True
CASGDLSRQGGAETLYF	False
CAWSLEHNSYEQYF	False
CASSQESGGLYAEQFF	False
CASSLVREGTEVFF	False
CASTLGTGGFYEQYF	False
CASSLDRESSDYTF	False
CASSLERGNTGQLYF	False
CASSLWDSSGNTLYF	False
CASSLDLGGNQDTQYF	False
CASSSGQTGNTLYF	False
CASRGLQDTQYF	False
CASSLDRRAVSAETLYF	False
CASRDWGSSYEQYF	False
CASSFAGQGAEQFF	False
CAWSPRTGGPYEQYF	False
CASSQDRGGYAEQFF	False
CASGDAEGAVYF	False
CASSDGQGGTEVFF	False
CASSQDWGEREQYF	False
CASSMYSANTEVFF	False
CASSPLGSQNTLYF	True
CTCGRDRNNERLFF	False
CASSHTGNYAEQFF	False
CASSQTGGGAETLYF	False
CASSFQGRDEQYF	False
CASSHRASYEQYF	False
CASSRTGTGNAEQFF	False
CAWSLGNYAEQFF	False
CASSSPGLQDTQYF	False
CASSHPAVSYEQYF	True
CASSTGQPNTEVFF	False
CASSSGGADTQYF	False
CASSDWGQDTQYF	False
CASGDDERLFF	False
CASGWGGENTLYF	False
CASGDAGGQDTQYF	True
CASSQGRQDTQYF	False
CASSLKGTSAETLYF	False
CGAREQGSQNTLYF	False
CASGDDNANSDYTF	True
CASGGPGHANTEVFF	False
CASGDSYEQYF	False
CASGPGGYAEQFF	False
CASSPGTGGIEQYF	False
CASSLRQQDTQYF	False
CASGTGDPYAEQFF	False
CASLRDTGQLYF	False
CASSLVGAEQFF	False
CTCSADGTGFYEQYF	False
CASSDWDSTEVFF	True
CASSLGLGGAEQFF	True
CASSLDNSDYTF	False
CTCSADVGESAETLYF	False
CASSRDDRGNTQYF	True
CTCSAEAGTGQAPLF	False
CASSPGGWDTQYF	False
CASGDVGGNQDTQYF	False
CASSLDGGPSAETLYF	False
CASSPGQGNSDYTF	False
CASSQEQYSGNTLYF	True
CASSLDGGAPAETLYF	False
CASSMWANTEVFF	True
CASSQEWLGQDTQYF	False
CASSPGGVGQDTQYF	False
CASSYDRANQAPLF	False
CASEGNYAEQFF	False
CASSELTGGYEQYF	False
CASRFGGAHAEQFF	False
CASSDWGYEQYF	False
CASSFSSGNTLYF	False
CASGDRGVYEQYF	True
CASGDAGQGNQAPLF	False
CASSRQGAYNSPLYF	False
CASSGLGGGGQDTQYF	False
CTCSAAANQDTQYF	False
CASSFYWGGGAEQFF	True
CASGDAGQGASNTGQLYF	False
CASSEDPWGDYAEQFF	True
CASSLDNWGQNTLYF	False
CASSFRDSSYEQYF	True
CASSSRGTGGAQDAETLYF	False
CASSDPGQISNERLFF	False
CASSLWGTGSNERLFF	False
CASSLGQNANSDYTF	False
CASSIGEEVFF	False
CASSFDASAETLYF	False
CASSDGNYNSPLYF	False
CASSSGASSAETLYF	False
CASSPGQTNSDYTF	False
CASSLWDNTEVFF	False
CASRNYAEQFF	False
CASARDWGYAEQFF	False
CASGDGGYEQYF	False
CASGDALGGLNTLYF	False
CASSRDLGGRAEQFF	False
CASSLGQGAGNTLYF	False
CASSRDRVNTGQLYF	False
CASSWDGSQNTLYF	False
CASSKWGSQDTQYF	False
CASSRTGNYAEQFF	False
CASSSLDEQYF	False
CASGDGNLSNERLFF	False
CASGDDGQGNQDTQYF	False
CASSELGYEQYF	False
CASSLLGKVTLYF	False
CTCSANWESSYEQYF	False
CASSLDAGEQYF	False
CASSPATGGQNTLYF	False
CASGAGLGLYAEQFF	False
CASSLPQYQDTQYF	False
CASSLEGLGGLQFF	False
CASSPYLPGQDSYEQYF	False
CTCSASGRDTEVFF	False
CASSWTSYAEQFF	False
CTCSAAGEGGQNTLYF	True
CASSQDRDNTEVFF	False
CASGDPDWGGSYEQYF	False
CASRRTENTLYF	False
CASGDVLGGQNTLYF	False
CTCSADREYNNQAPLF	False
CGAWDWGEKDTQYF	False
CASSSRQNNYAEQFF	False
CASSLGQVDTQYF	False
CASSLEGTNSDYTF	False
CASSTGGAGNTLYF	False
CAWSPGHQNTLYF	False
CASGRTGGRSQNTLYF	True
CASSLAQADEQYF	False
CASSQGLGDEQYF	False
CASRSGRGVNTLYF	True
CASSDVGRDSDYTF	False
CASGDAYWGDTQYF	False
CASSQWTTSAETLYF	True
CTCSADNEQYF	False
CASSPPTGDSAETLYF	False
CASGDYRDRGSTEVFF	False
CASGDAFQSNTEVFF	False
CASSGTGGNYAEQFF	False
CASSLDTGNSDYTF	False
CASSHRGSNERLFF	False
CASSLDWGYAEQFF	False
CASSPDWGTQDTQYF	False
CASSPWGAYEQYF	False
CASSSGYEQYF	False
CASRETGANTEVFF	False
CASSPTGGFYEQYF	False
CASSDGGDSDYTF	False
CASSQWGSQNTLYF	False
CASSRTPGNTLYF	False
CASSDMGGVYAEQFF	False
CTCSADNSGNTLYF	False
CASSLVAEQFF	False
CTCSGGQGGDAEQFF	True
CGARDRSSYEQYF	False
CASSFWGQGQNTLYF	True
CASSHSSGNTLYF	False
CASSLWGGDTGQLYF	True
CASSPGRRSGNTLYF	False
CAMGDSYEQYF	False
CASSVTGDQDTQYF	False
CASSMKGQGTNERLFF	False
CGARSRGGRDTLYF	False
CASSWGGNNQDTQYF	False
CASSHPGQSNTGQLYF	False
CASSIGRDNSYEQYF	False
CGAPFGKNTLYF	False
CTCSARGTGQLYF	False
CASSFMGAYEQYF	True
CASSEYRDEVFF	False
CASSSGLGDSYEQYF	False
CASSDAWGSPDYTF	False
CASSMRTEVFF	False
CASSPGLSNERLFF	False
CASSDRAGTGQLYF	False
CASSLDKANSDYTF	False
CASSLDWGVSAETLYF	False
CASSEPNNYAEQFF	False
CASSADWGANQDTQYF	True
CASSPGQYEQYF	False
CASSQDGLGGGYEQYF	False
CASSSGQYSDYTF	False
CASSQDSGGEQYF	False
CASSLVGGPSAETLYF	False
CASSQTGVYEQYF	True
CASSFQGAYEQYF	False
CASSLVQINQAPLF	False
CASGPGLGEGEQYF	False
CASSGLFQNTLYF	False
CAWKLGAETLYF	False
CASSQDRQNTEVFF	False
CASSSRDRNNYAEQFF	False
CASSPLLGQDTQYF	False
CASSDSSYNSPLYF	False
CASSDGGLAETLYF	True
CASSDRVGNTLYF	False
CASSRLGGPSSAETLYF	False
CASSNNTEVFF	False
CASSLPAISGNTLYF	False
CASGDGVGTEVFF	False
CASSDRGQINSDYTF	False
CASGDWGLNTGQLYF	False
CASSWDNSGNTLYF	False
CASSSDWGRGAETLYF	False
CASSPRAADYTF	False
CASSHWGSQNTLYF	False
CASSQVAGDYAEQFF	False
CGARDAGNSDYTF	False
CASSFGWGNQDTQYF	False
CASSLDWGYEQYF	False
CASTDRGRNQAPLF	False
CASSIRGLAETLYF	False
CASSITGGAREQYF	False
CASSSGQGVFF	False
CASSIRRGGNTLYF	False
CTCSGGSNTEVFF	True
CASSQDNWGGKNTLYF	False
CASSSRTGGARDAETLYF	False
CASSSGLGGTLYF	False
CASSIVEGGNTEVFF	False
CASSRESGVNTGQLYF	False
CASSLGVSYEQYF	False
CASSQDPGLGPYAEQFF	True
CASSDWDSQAPLF	False
CTCSAAWGNAETLYF	False
CASSQDLSNERLFF	False
CASSFWAGGNYEQYF	True
CASSDATGVYAEQFF	False
CASSDNWGYQDTQYF	False
CASSDWGYAEQFF	False
CASSRTEANTEVFF	False
CASSWTGGVQDTQYF	False
CGARARDSQNTLYF	False
CASSSGTGGALYF	False
CTCSDWGEQYF	True
CASSPQGYEQYF	False
CASSEAGQGNERLFF	False
CASSLGHISNERLFF	False
CASGDWGNYAEQFF	False
CASGAGTGSSAETLYF	True
CASTATGGADEQYF	False
CASSLDAGQGGNTLYF	False
CASSHRDRGSDTQYF	False
CGARDWVSSYEQYF	False
CASSPTKNTLYF	False
CASRGGTEVFF	False
CASSQGTGGRNSPLYF	True
CASRDRGTEVFF	False
CASSYRDRGHAETLYF	False
CASSDFTNTEVFF	True
CASSPAGNSYNSPLYF	False
CASSQDRGYEQYF	True
CASSDGYSGNTLYF	False
CASGDAHTNERLFF	False
CGAWDRNYAEQFF	False
CASSSGQGKYTEVFF	False
CASSYNTEVFF	False
CASSLGGGALYEQYF	False
CASGDAVGGVQNTLYF	False
CASSPQENSDYTF	True
CASGDRRDKYEQYF	False
CASGDAFGGERLFF	False
CASSQGLGDTLYF	False
CASRRGTGGPNYAEQFF	True
CASGERYEQYF	True
CASSIWTGGKAPLF	False
CASSLFRDAEQFF	True
CASSDPGGNYAEQFF	False
CASSPETIYAEQFF	False
CASSQNSDYTF	False
CASSLARGNSDYTF	False
CASSLEDWGGSQNTLYF	False
CASSDNSDYTF	False
CASSRDWGTSAETLYF	False
CASGDVNQAPLF	False
CASSQEWGGAETLYF	False
CASGDARTNYAEQFF	False
CSRGQTSAETLYF	False
CASSPDRGLAEQFF	False
CASSPTGGYAEQFF	False
CASGDEGQGADTEVFF	False
CASSQEGWGDTLYF	False
CASSMGSSYEQYF	True
CASSIYRANTGQLYF	False
CASSDAGGEEVFF	False
CASSLPINTGQLYF	False
CASSTGGAPAETLYF	False
CASSQVGLGEGTGQLYF	False
CASRRLGSSYEQYF	False
CASSPRTGETEVFF	True
CASSLPGQGAGTLYF	False
CASSWDTNSDYTF	False
CASSPGHSNERLFF	False
CASGSRGVNQAPLF	False
CASSHDWGSQNTLYF	False
CASSPDRSSYEQYF	False
CASSPGGLDTQYF	False
CASSLGGSYNSPLYF	False
CASSQDMDWGYEQYF	False
CASSRVGTGGYEQYF	False
CASSLWGGAEQYF	False
CASSAGRSYNSPLYF	False
CASSPGTFSYEQYF	False
CASGDAAGNERLFF	False
CASGDAAGGVEQYF	False
CASSPESERLFF	False
CTCSEDSSYNSPLYF	False
CASSPTLGGRAQNTLYF	False
CASSLPAAQYF	False
CASSSGTERLFF	False
CASSQDFYEQYF	False
CASSRDTNTGQLYF	False
CASKLGGDQDTQYF	False
CGARGWPDTQYF	False
CASSLSNDAEQFF	False
CASSVTSANTEVFF	False
CASSQEDWGGEQYF	False
CASSLWVQDTQYF	False
CASSPGLGGAETLYF	False
CASSPDRPQNTLYF	False
CAWSLGGAGNTLYF	True
CASSAGLGGEQYF	False
CASSLGTGGFERLFF	False
CASGDLGGYAEQFF	False
CASSELGGRDTGQLYF	False
CASSSWDRGAGYAEQFF	True
CASSAHRGQDTQYF	False
CASSPGTGGGSTEVFF	False
CASRGTGGAQNTLYF	False
CTCSAGTGGSAETLYF	False
CASSPWGEGEQYF	False
CASSDVTGGSYEQYF	False
CASSDGQGPNYAEQFF	True
CASSIGISNERLFF	False
CASSPGIERLFF	False
CASSQRRDNYAEQFF	False
CASSLDRVANTEVFF	False
CASSEGTGAETLYF	False
CASSDWVQDTQYF	True
CASSLDRVGNTLYF	False
CASRGGGHNSPLYF	False
CASSLDNSAETLYF	False
CASGNNERLFF	False
CASSLGLGGYAEQFF	False
CASSPGLGGINQDTQYF	False
CASSDWTNTEVFF	True
CASSWTSNTEVFF	True
CASSPRTGANTGQLYF	False
CASSLLWGLFF	False
CASSRRTGASAETLYF	False
CASSFGTGSYEQYF	False
CASSFRDRGSDYTF	False
CASSLGTGGAGQNTLYF	False
CASSRGVGVFF	False
CASSRRDWGYEQYF	False
CASGGGTTNSDYTF	False
CASSLSVNERLFF	False
CASSITRLGGQDTQYF	False
CASSRKNSDYTF	False
CASSPSGISNERLFF	False
CASGDAAGAEQYF	False
CASSQLHNTGQLYF	False
CASSLDWGGTNTGQLYF	False
CASSDGTGNTEVFF	False
CASSQAWGINQDTQYF	False
CASGDGLGGQDTQYF	False
CASSLSRGGLYEQYF	False
CASGDREEQYF	False
CASSDSSGGGSGNTLYF	False
CASSPGQNSDYTF	False
CASRGTGSSAETLYF	False
CASSIYREDTEVFF	False
CASGDGLYEQYF	False
CASSFWGGGAETLYF	False
CASSSTGSYEQYF	True
CASSQEGGINERLFF	False
CASSQVGGGPNYAEQFF	False
CASSSTSNYAEQFF	False
CASSLVGGAEQFF	False
CASRNHRYGYAEQFF	False
CASSYRWGSAETLYF	True
CASSPRQGASGNTLYF	False
CASSLGGARDSDYTF	False
CASSEGWGAGTQYF	True
CASSPGNYAEQFF	False
CASSTDYAEQFF	False
CASGDGWGGNTLYF	True
CASSLEGQNQAPLF	False
CASGDAAGGVTLYF	False
CASGDTGYAEQFF	True
CASSDAGGLSYEQYF	True
CASSLLGAGAETLYF	False
CASSAGGLAEQFF	False
CASSSTGTGNAEQFF	True
CGAWDRVGSDYTF	False
CASSDDWGQNTLYF	False
CASSLGGPSSYEQYF	False
CASKTGGYAEQFF	False
CASSPDNAEQFF	False
CASSTPINTEVFF	False
CASSLGTSGNTLYF	True
CASSPGNSQNTLYF	False
CASSDRLGDYAEQFF	False
CTCSAGGAYAEQFF	False
CASGDAVSNERLFF	False
CASGLGAYEQYF	False
CASSRDRGTGQLYF	False
CASSRTGYEQYF	False
CASSDAGADNNQAPLF	False
CASSLTANSDYTF	False
CASSPRASNSDYTF	False
CASGDAMGSETLYF	False
CASSISPRGQGFNERLFF	False
CASGLGGRDTQYF	False
CASSIEDRYEQYF	False
CASSDARGQDTQYF	False
CASGDVGGVQDTQYF	False
CASSSRGGGAETLYF	False
CASSEGGNSDYTF	False
CASSQERTGYEQYF	False
CASSEWNSGNTLYF	True
CASSRDWGNTGQLYF	False
CASSLDRGREQYF	False
CASSLGGGSNTEVFF	False
CASSADRVGQYF	False
CASSLDEGGLVFF	False
CASSERQGANSDYTF	False
CASSGLPAEQFF	False
CASSLYGAEDTQYF	False
CASGHRANSDYTF	False
CAWLGGSDYTF	False
CASSLTGASAETLYF	False
CASSLLGDTLYF	False
CASSYGTGNSYEQYF	False
CASGDAAGGERLFF	False
CASSHTGVQNTLYF	False
CASSLGGGVYEQYF	True
CASSQDWDYAEQFF	True
CASGDRAEQFF	False
CASSRDRGTTNERLFF	False
CASSDWDSSGNTLYF	True
CASSRGQGNYAEQFF	False
CASSSPRDRGAETLYF	False
CTCSAASGGDQDTQYF	True
CASSLGPPSDYTF	False
CASSLGVSNERLFF	False
CASSRQGNQDTQYF	False
CASTRGEDTQYF	False
CASSPGNTEVFF	False
CASSTTGDNTEVFF	False
CASSYDGNTEVFF	True
CASSLQEEYF	False
CASRPGGANYAEQFF	False
CASSQRGREQYF	False
CASSLTGHSGNTLYF	False
CASSPRQYEQYF	False
CASSQLKGTYEQYF	False
CASSLGGGAETLYF	False
CASSDAAQSNTEVFF	False
CASSWDRNSDYTF	False
CASSQDIGDTEVFF	False
CGAGTGPEVFF	False
CAWSLWGGDTLYF	True
CSSRGTGGSQNTLYF	False
CASSLVETDAEQFF	False
CASSFLRDRGNAEQFF	False
CASSLDTGGSQDTQYF	False
CASSRLGEDTQYF	False
CTCSAEQDTQYF	False
CASSPWGDTQYF	True
CASSRGRGTEVFF	False
CASSLTNANTEVFF	False
CASGDAGGGETLYF	False
CASSMWGDTQYF	True
CASSQDFSANTEVFF	False
CASSLVGGRGAETLYF	False
CASSQGLVYAEQFF	False
CASSDATGDTEVFF	True
CASSTGQSQNTLYF	False
CASRTGTGGQDTQYF	False
CASSPGQGTETLYF	False
CGARDLGGSYEQYF	False
CASSQDSGNYEQYF	False
CASSEGQYAEQFF	False
CASSRTEVFF	False
CASSLRGADTEVFF	False
CASSLSGTNTEVFF	False
CASLGGEQYF	False
CASGDRAENSGNTLYF	False
CSSRDRGEQYF	False
CASGDAWGGETLYF	False
CASRGGGAETLYF	False
CASSLRDRDDTGQLYF	False
CASGDVGGQNTLYF	False
CASSLGGRQDTQYF	False
CASSFGLGAETLYF	False
CASSRGRLNTEVFF	False
CASGGQDYAEQFF	False
CASSPLTSQNTLYF	False
CTCSAVWGTYEQYF	False
CASRGTGGSSSYEQYF	False
CASSPGLGGRQNTLYF	False
CASSDLGNSQNTLYF	False
CTCSATGTPEVFF	False
CGARDRGNERLFF	False
CASSLSGGAGENTLYF	False
CASSLDSLGTNTGQLYF	False
CASSLAWGYEQYF	False
CASRRTGGDQDTQYF	False
CASSWTGRAEQFF	False
CASSQRGAEGQDTQYF	False
CASSLGTGGSNQAPLF	False
CTCSADRTGHTEVFF	False
CASSPGQGWDTQYF	False
CASSFYRGYAEQFF	False
CASSPDWGGYAEQFF	False
CASSRLGAETLYF	False
CASTRTGADTGQLYF	False
CASSLGLGGYEQYF	False
CASSLRQNTLYF	True
CASSPGGAYEQYF	False
CASSLTGQANSDYTF	False
CASSQDRGYAEQFF	True
CASSPDWGTSAETLYF	True
CASRGDKINTGQLYF	False
CASSYRGSNSDYTF	False
CASSPGWGANQDTQYF	False
CASSPGQSYNSPLYF	False
CASSLGGSNTGQLYF	True
CASSRTGGAQDTQYF	True
CASSQDRTGGEQYF	False
CASGDASYEQYF	False
CASSLGGGTNERLFF	False
CASRYRGAETLYF	False
CASSLEQMNNQAPLF	False
CASSRDWGVGYAEQFF	False
CASSPVPYEQYF	False
CASSQEWGADYAEQFF	False
CASGDSGGAFSYEQYF	False
CASSFSGGYEQYF	False
CASSPGNNNQAPLF	False
CASSDAGFAEQFF	False
CASGDSQDTQYF	False
CASSSGTGQDTQYF	False
CASGDTGRGAETLYF	False
CASSPNTEVFF	False
CASSSRGGNTLYF	False
CASSLGLGGTLYF	False
CASRPRDERLFF	False
CAWRRAGGGAETLYF	False
CASSYGISNERLFF	False
CASSLDELNWVNYAEQFF	True
CASSPRGQGSYEQYF	False
CASGDNYNSPLYF	True
CASSPRHPNTGQLYF	False
CASSLDRANTEVFF	False
CTCSAGQSSYEQYF	True
CASSLGDRAHYEQYF	False
CASSGTGREQYF	False
CASTPRDISAETLYF	False
CASSLRRGVDAEQFF	False
CASSLGGAGNTLYF	True
CASRSGVDTQYF	False
CASSLEGGRLDERLFF	False
CTCSAEREDTGQLYF	False
CASSDGAFYEQYF	False
CASSLGNYEQYF	False
CASSLDYWGGSQNTLYF	False
CASSPGQNYAEQFF	False
CASSRDWGAYEQYF	True
CASSPGQATEVFF	False
CASSLDGAGGENQDTQYF	False
CGAREGGYEQYF	False
CASRVLGNYAEQFF	False
CASTSGADTQYF	False
CASSDAYNNQAPLF	False
CASSLSNWGNYEQYF	True
CASGDWGGNQDTQYF	False
CASSLVDSGGGTGQLYF	True
CASSQDLRGGGQNTLYF	False
CASSLAWGASAETLYF	False
CASSLGDWGNAETLYF	False
CASGGRNNYAEQFF	False
CASRPLRGTGQLYF	False
CASSPDWGNYAEQFF	False
CTCSAGTGNSNSDYTF	False
CGAGDGPNSDYTF	False
CASSIGGEQYF	False
CASTGGAQDTQYF	False
CASSYRGRLDTQYF	False
CASSFRDSEQYF	False
CASRQGSQNTLYF	False
CAWSLRGNSDYTF	False
CASGDAGGSSYEQYF	False
CASSAGGANTEVFF	False
CASSLHRDYNSDYTF	False
CASGVPGLGSQNTLYF	False
CASSIGQNSGNTLYF	False
CASSQTGTINNQAPLF	False
CASRTGNTGQLYF	False
CGARDNWGAETLYF	False
CASSQDGTMNQAPLF	False
CASSQGGGANSPLYF	False
CASSQEGTGENEQYF	False
CASSDSGGDAETLYF	False
CASSRGTGEDTQYF	False
CASSQEDTQDTQYF	False
CASSLAPGGTSAETLYF	False
CASGDRSGANYAEQFF	False
CASSLDRNSGNTLYF	False
CASSSTGSVQAPLF	False
CASSDSSYEQYF	False
CASSQDLGGQNTLYF	True
CASSPPPGSNTEVFF	True
CASIGGSGNTLYF	False
CASSLVGASAETLYF	False
CASGDAGEQYF	False
CASGWGGANERLFF	False
CASSFGDWASAETLYF	False
CASSIDRNTLYF	False
CASSSSGTDNYAEQFF	False
CASSDWRDTEVFF	True
CASRSSYEQYF	False
CASSPPLSSQNTLYF	False
CASSDDWGGWAEQFF	False
CASSPGQGGGNTLYF	False
CASSRDSLTEVFF	True
CASSDETENTLYF	False
CGARMGAGQDTQYF	False
CASSLGGMDTLYF	False
CASSLPTHQAPLF	False
CASSDRGASNTGQLYF	False
CASSLALGAAETLYF	False
CAWSLSRGQNTLYF	False
CASRDRGCAEQFF	False
CASSLEGRGRNSPLYF	False
CASSPGQRNTLYF	False
CASSLSRYEQYF	False
CASSGTGKGSPLYF	False
CASSSTTGGQDTQYF	False
CASGDRQAGSAETLYF	False
CAWSQGTGGYEQYF	False
CASSQVDINYAEQFF	False
CASGESAYEQYF	False
CASGMDKANSDYTF	False
CASSLGQSSYEQYF	False
CASSLGQTNSDYTF	False
CASSSDWGSSYEQYF	False
CASSRDWGGYEQYF	False
CASSLAWGEDTQYF	False
CASSLEGRGVNQDTQYF	False
CGARDLPVSPLYF	False
CASSQERTGTEVFF	False
CASSLGGGYEQYF	False
CASSLRDGYAEQFF	True
CASSLDGGAGVFF	False
CASSAQGNNYAEQFF	False
CASSPGQFNERLFF	False
CASGDAGRQNTLYF	False
CASSIRDRGLAEQFF	False
CASMWGGYAEQFF	False
CASSQDSHSSQNTLYF	False
CASSLGQYYAEQFF	True
CASSDGGTGGYEQYF	False
CASSQDPGGQDTQYF	True
CASSYRDIANTEVFF	False
CASSFRDRGYEQYF	False
CASSPPASQNTLYF	False
CASTPRRGNTEVFF	False
CASSPGLGFSQNTLYF	False
CASRPGTGGNQAPLF	False
CTCSADRTEYEQYF	False
CASSDNWYEQYF	False
CASSILRGSYEQYF	False
CASSQDRDSDYTF	False
CASSPGTGNTEVFF	False
CASSLDDWGSYEQYF	True
CASSLDRDGNTLYF	False
CASGRRGGRGDTQYF	False
CASSSWGDTGQLYF	False
CASSSGTGGPEQFF	False
CTCSAAAGGYNSPLYF	True
CASSPTGGAYAEQFF	False
CASSQDRDWGGYEQYF	False
CASSLGGRNAETLYF	False
CASSLVWGVAEQFF	False
CASSKGQGYAEQFF	False
CASSFRNYAEQFF	False
CASSQEGRDTEVFF	False
CASSQVAGGGNTLYF	False
CASSLFAGGYEQYF	True
CASSLRDKYAEQFF	False
CGARGIEDTQYF	False
CASSQDGTGNTEVFF	False
CASGDAQGYERLFF	False
CASSQGNSGNTLYF	False
CASSRDAWDWGGAETLYF	True
CASSLERTFYEQYF	False
CASSFPGQLYF	True
CASGKDSSGNTLYF	False
CASSRDWGQDTQYF	False
CASSPGGAQNEQYF	False
CASSGQGYEQYF	False
CASGGQNANSDYTF	False
CASSGPGQSSYEQYF	False
CASSFLVYEQYF	False
CASSLAQGHTEVFF	False
CASSLAKNTGQLYF	False
CASSQDRGEDTQYF	False
CASSPTYSGNTLYF	False
CASSDWTHTEVFF	True
CASSVMGQGTEVFF	True
CGAQGYTEVFF	False
CAWSPRDWGNQDTQYF	False
CASSLTGGAREQYF	False
CASSQDVGGSSYEQYF	True
CASSPGTGGNSDYTF	False
CASSFQGSYEQYF	False
CASSQEAWVSNERLFF	False
CASSRDRGNTEVFF	False
CASSSGLGEDTQYF	False
CASSLDRTGQLYF	False
CASSLDRFDERLFF	False
CASSIGASQNTLYF	False
CASSLLGGDTGQLYF	False
CASRTRNERLFF	False
CASSPGLGGRGDTQYF	False
CASSLAGISNERLFF	False
CASSDQGGRVEQYF	False
CASSLDRGLAETLYF	False
CASSRDWGNYAEQFF	False
CASSVPGLGGRSYEQYF	False
CASSPGQGRDTQYF	False
CASSRGLSAETLYF	False
CASGAQGIDAEQFF	True
CASSHRDNSYEQYF	False
CASSDYGEGDTEVFF	False
CASSQDWGGDEQYF	False
CASSHTSNQDTQYF	False
CASSSTGGISYEQYF	False
CGAREGGAGEQYF	False
CASSPRLGGRDTQYF	False
CASSLGGAQDTQYF	False
CASSHLGGQDTQYF	False
CASSFRDRGDTQYF	False
CASSLDRGEQYF	False
CASSPGTVNTGQLYF	False
CASSRDRSPNERLFF	False
CASSRDLDEQYF	True
CASSLTQTANTEVFF	False
CASSLRDWGSYAEQFF	False
CASSKEVFF	False
CASSMGTNSGNTLYF	False
CASSMDWGGPNTGQLYF	False
CASSLAAKEVFF	False
CASSSGSETLYF	False
CASSDETGWTEVFF	False
CASSQGDISYEQYF	False
CASSETGGATQYF	False
CASSWTGGKEQYF	False
CASSRDWGGREQYF	False
CASSLGLGDYYAEQFF	False
CASSYGQGANNQAPLF	False
CTCSAGTGGYERLFF	False
CASSGGQNQAPLF	False
CASSWTYNSPLYF	False
CASSIGGARQNTLYF	False
CASSSSYEQYF	False
CASSLRLGGKDTQYF	False
CASSPGGRWAEQFF	False
CTCSAARNTEVFF	False
CASSITGGYEQYF	True
CASSPGGGQNTLYF	False
CASSQGLGGEQYF	False
CASSRGRGDTEVFF	False
CASSDWGQNTLYF	False
CASSEGNYNSPLYF	False
CASGDPTEINERLFF	False
CASSLWTGRDEQYF	False
CASSPHWGGGTQYF	False
CASGDVGGPSEQYF	False
CASGRDKYAEQFF	False
CGAREGEDTQYF	False
CASSPTFANTEVFF	False
CASSLGEEDTQYF	False
CASGDRDWGSSAETLYF	False
CASSTRDSSYEQYF	False
CASSLRLGSYEQYF	False
CASSSTGFSAETLYF	False
CASSWENSAETLYF	False
CASSLAGGQDTQYF	False
CASSLYRGREQYF	False
CTCSAGQGGNSPLYF	False
CASSKGGLAYNSPLYF	False
CASSQTRGNQAPLF	False
CASTTGYNSPLYF	True
CGALTGGNTEVFF	False
CASDSGNTLYF	False
CTCSAGGADQDTQYF	False
CASSLDGHTGQLYF	False
CGARDQDNRNTEVFF	False
CASSLGTGYSDYTF	False
CASGDEVRGPSYEQYF	False
CASSRLGGAFYEQYF	False
CASSIRGREQYF	False
CASSDAGVQDTQYF	False
CASKGYYAEQFF	False
CASSLGLGDEQYF	False
CASNQGNYAEQFF	False
CASSDWTDTEVFF	True
CASSSEGKGNTEVFF	False
CASSPGGTDTQYF	False
CASSPGTVSNERLFF	False
CASSLDRGGEQYF	False
CASSRTGGGAETLYF	False
CAWSPGQGNTEVFF	False
CASSSPGQGFERLFF	False
CASSFWGGEQYF	False
CASSLGSSYEQYF	False
CASGDRDRGNYAEQFF	False
CASSPGTGSYEQYF	True
CASSLDWGDSYEQYF	False
CASSPGLGEDTQYF	False
CASSFANNYAEQFF	False
CTCSAERVGAEQFF	False
CASSRTGYSDYTF	False
CASGDESGGARETLYF	False
CASSRTGSSYEQYF	False
CASSDVQVNYAEQFF	True
CASSYTRDGNTEVFF	False
CTCSGHNQAPLF	False
CASGDSQNTLYF	False
CASGERLGGYEQYF	False
CASNRDNYEQYF	False
CASSQLGDEQYF	False
CASSSRDRGLAEQFF	False
CASGDAKGDSDYTF	False
CGAREGGGNTGQLYF	False
CASSIGQINSPLYF	False
CASSLVGESNTEVFF	False
CASSGLRDTQYF	False
CASSDAGANTEVFF	True
CASSLYSYAEQFF	False
CASSPGGANTEVFF	False
CSSRTGTSAETLYF	False
CASGVDRESAETLYF	False
CASSSDRVYEQYF	False
CASSYSQDTQYF	False
CASGDRGFEQYF	False
CASGDAISNERLFF	False
CASSLLQSQDTQYF	False
CASSQDWGGSAETLYF	False
CASSLAGPNERLFF	False
CAWSPTGDSYNSPLYF	False
CASSDNSYNSPLYF	False
CASGDRGAGNAETLYF	False
CASSDPNSDYTF	False
CASSLEGGLIAETLYF	False
CAWSLTDRGTGQLYF	False
CASRGGNQDTQYF	False
CASSRLEGGQNTLYF	False
CASTLTGEDTQYF	False
CASGDARDYEQYF	False
CASRLQNTLYF	False
CTCSAGTYSNERLFF	False
CASSRLGGNQDTQYF	False
CASSGGTEVFF	False
CASSDSRTGDNYAEQFF	False
CTCSAATTGGNTEVFF	False
CASGDVGAGNTLYF	False
CASSSPGTGNTEVFF	False
CAWSLRGGYYAEQFF	False
CGARARGNERLFF	False
CASSWTGAGNTLYF	False
CASSLTGINQDTQYF	False
CASSLVGYAEQFF	False
CASSKDNSGNTLYF	False
CASSYWGGQDTQYF	False
CASSFQGGGNSDYTF	False
CASSQRTYEQYF	False
CASSEGMLNQNTLYF	False
CASTSNTGQLYF	False
CASSDRNSDYTF	False
CASSYLSNERLFF	False
CASSLRTGGTSAETLYF	False
CASGGLYGGVAETLYF	False
CASSLRTNQNTLYF	False
CASSPGGGYAEQFF	True
CASSRTRNNQAPLF	False
CASSLSIWGREVFF	False
CASGGTGGQDTQYF	False
CTCRQTINTGQLYF	False
CASSGLGGSSYEQYF	False
CASSQGAGASTEVFF	False
CASSPTGGRNYAEQFF	False
CTCSADWGGAETLYF	False
CASSLWGGYEQYF	False
CASSPGGGDTEVFF	True
CASSDRDWGYEQYF	True
CASKGDTPNTEVFF	True
CASSVDRVEQYF	False
CTCSAQGSSDYTF	True
CASSDAGGSAETLYF	False
CASSGGWGDYEQYF	False
CASRGGAETLYF	False
CASSDTQGFNNQAPLF	False
CASSPGQPQDTQYF	False
CGARQGDTQYF	False
CASGDALGGHTQYF	False
CASSLGGTEQFF	False
CASSLWGGGAEQFF	False
CASGDVRVYAEQFF	True
CASSYGASAETLYF	True
CASSVDRAGNTLYF	False
CASSGGGQNTLYF	False
CASSPDWGGGAETLYF	False
CASSMGPPRGERLFF	False
CASRTANERLFF	False
CASSDSRDANTEVFF	False
CASRRTGASAETLYF	False
CASSPTGTGNSPLYF	False
CASSLGGIDTEVFF	True
CASSPTGEGNTEVFF	False
CASTPDSANTEVFF	False
CASNPWGGQNTLYF	False
CASSQDPGANTGQLYF	True
CASGGEDTQYF	False
CASRQQGYEQYF	False
CASSLSGRRFEQYF	False
CASSGTGAEQFF	False
CASSLSKNTEVFF	False
CASSHRDFNYAEQFF	False
CASSPPGLGYEQYF	False
CASSLEREGTLYF	False
CASSPDNYEQYF	False
CASSVQGANYAEQFF	False
CASAGGRGEQYF	False
CASTGTASAETLYF	False
CASSLDWGNYEQYF	False
CASSFDRGLTEVFF	True
CASSLDGTEQAPLF	True
CASGDAVGGEAQYF	False
CASSLAGTGNSDYTF	False
CASSRQGYEQYF	False
CASGDRQGYEQYF	False
CASGDPGRANTEVFF	False
CASSTGQYEQYF	False
CASSEGSSAETLYF	False
CASSAGTGYNSPLYF	False
CASGEGHQNTLYF	False
CAWSLAGDSDYTF	False
CASSPTTNTGQLYF	False
CASSPNSYEQYF	False
CTCSADRDGNQAPLF	False
CASSDAHPNTEVFF	True
CTCSALGVNYAEQFF	False
CTCSADSGQNTLYF	False
CASSSRDWGVYEQYF	False
CASSLSSGQLYF	False
CASSQGLGGYEQYF	False
CASRLRDNNQAPLF	True
CASSDGRFSNERLFF	False
CSSTARGGNTLYF	False
CTCSADHRQDTQYF	False
CGARDQQSSNERLFF	False
CASSLGDRNSDYTF	False
CASSDGGRNSDYTF	False
CASSIGDWGSQNTLYF	False
CGARQGLSYEQYF	False
CASSDAGGGDTQYF	False
CASSLGLGGREQYF	False
CASSQTGANQAPLF	False
CASSSGTGRDTQYF	False
CASSPDWGASAETLYF	False
CASSTGLANTGQLYF	False
CAWSLRGRGEQYF	False
CASSLMTGGIGNTLYF	False
CASSGTGENTLYF	False
CASSDPGGNTLYF	False
CASGETWGSQNTLYF	False
CAWSRRLVNYAEQFF	False
CASSDWESTEVFF	True
CASSARDWGDHEQYF	False
CASSPTGIQDTQYF	False
CASSGTGANSDYTF	True
CASSAASASQNTLYF	False
CASSLSRGYNYAEQFF	False
CASSIGIGEDTQYF	False
CASSPLTGGAQDTQYF	False
CASSLGGYEQYF	False
CASSLDGTGGAEVFF	False
CASSLDEQYF	False
CAWSLNWANYAEQFF	False
CASSAGGDYAEQFF	False
CASGDPENTLYF	False
CASSQGTVYAEQFF	False
CTCSADEVSNERLFF	False
CASGAGNANTEVFF	False
CASSPHGDEQYF	False
CASSEDWGPNTGQLYF	False
CASSADWGGREQYF	False
CASSPTGGARDTQYF	False
CASSMGSGNTLYF	False
CASSFRDRGLAEQFF	False
CASSLGGLTEVFF	False
CASRLGQNTGQLYF	False
CASGEGLGVAEQFF	False
CASSLEGAGNTLYF	False
CASGDAMAGGEVFF	False
CASSPYRNSGNTLYF	False
CASSLELGAITGQLYF	False
CASSRRDIANSDYTF	False
CASSLGLGFYEQYF	False
CASSIRGADTQYF	False
CASSLGQLQDTQYF	False
CASSLDTYAEQFF	False
CASSRHSDYTF	False
CASSLDQNTEVFF	False
CASSYDWGASSYEQYF	True
CASSLVDWGAYAEQFF	False
CASSQETDSNERLFF	False
CTCSADRANERLFF	False
CASSGLGGGEQYF	False
CASSLLGAAEQFF	False
CASSGQANERLFF	False
CASGKGAAEVFF	False
CASGDAGGNTEVFF	True
CASGDEVSQNTLYF	False
CASSLGQYEQYF	False
CASSIGQSNTEVFF	False
CASSLPRLASQNTLYF	False
CASSLGQTQDTQYF	False
CSSSQRGQNTLYF	False
CASTRTEYEQYF	False
CASSPNWGGSEQFF	False
CASSLARQDTQYF	True
CASSFRNSDYTF	False
CTCSGDWGSQNTLYF	False
CASSVTGWDSDYTF	False
CASSLSPSGNTLYF	False
CASSPRDNNYAEQFF	False
CASSQDWDRYEQYF	False
CASSLADQDTQYF	False
CASSSGQGANERLFF	False
CASSDRDWALAEQFF	True
CASSTGGYAEQFF	False
CASSDQGGWAEQFF	True
CASSPGTGGAYAEQFF	False
CASSGPEVFF	False
CASSEGTGIERLFF	False
CASGQGYEQYF	False
CASSDTGGVSYEQYF	False
CTCSAGTNTEVFF	False
CAWSLRGNYAEQFF	False
CASSYGGGANERLFF	False
CASSWGLGGDAETLYF	False
CASSRDWGGAAETLYF	False
CASSQDLGDEQYF	False
CASSIGTGGNSPLYF	False
CASSAGGGSTGQLYF	False
CASGDDRGQDTQYF	False
CASSSGQGGTEVFF	False
CASRWTGDEQYF	False
CASSDMGQGYEQYF	False
CASSLFGKDTQYF	True
CASSMGLGQNTLYF	False
CASWGGSYAEQFF	False
CASSSNSQDTQYF	False
CASIISQNTLYF	False
CASSLDWGQDTQYF	False
CASSFLGSYAEQFF	False
CASSDIREFYEQYF	False
CASSDPGGNSPLYF	False
CASSTRGTSNTEVFF	False
CASSQTGANTEVFF	False
CASSEPGGSSYEQYF	True
CASSDAVDSDYTF	False
CASGDAQGRNTLYF	False
CASSDWANTEVFF	True
CASSESQGSNTEVFF	False
CASRGLGGSYEQYF	False
CASTTGVDTEVFF	False
CASSLSTGYEQYF	True
CASSPGTGGETLYF	False
CASSDWGPYEQYF	False
CASSLVGTPNYAEQFF	False
CASSSRDRGVYEQYF	False
CASSPTGVLQNTLYF	False
CASSLERGGTGQLYF	False
CGARPVSGNTLYF	False
CASSLGDRGYEQYF	False
CASSDRGQDTQYF	False
CASIDWGENTLYF	False
CASSFGRAGNTLYF	False
CASSSTGANTEVFF	False
CASSQGTGGSQNTLYF	False
CASSLGGTETLYF	False
CASSAGTNYAEQFF	False
CASSLQGGAETLYF	False
CASSGWGGDGEQYF	False
CASSLYRGDSDYTF	False
CASGHHQDTQYF	False
CASRNSYNSPLYF	False
CASSAGLGGQNTLYF	False
CASSIEGTGVDEQYF	False
CASSFTANQDTQYF	True
CSSRVQGFAEQFF	False
CASGDKGGQDTQYF	False
CTCSALGSQNTLYF	False
CAWSLQAPLF	False
CAWSLPGGYEQYF	False
CASSYDTYEQYF	False
CASSSNRVAETLYF	False
CASSIFQNTEVFF	True
CASSDWGGNTGQLYF	False
CASSLGERLFF	False
CASSFDWGGDYAEQFF	False
CASSAPPNTLYF	False
CASSGGTKDTQYF	False
CASSLSQGGGEQYF	False
CASSETGGYEQYF	True
CASSLGTGGRGTEVFF	True
CASSEDRGFEQYF	False
CASGDGGRLSGNTLYF	False
CASSGLGGQDTQYF	False
CASSLVGREQYF	True
CASGVNTLYF	False
CASSFNWGSYEQYF	False
CASGDGFANTEVFF	False
CASSSDWESSYEQYF	False
CASSHRYRGSGNTLYF	False
CATSTGSSYEQYF	False
CASSLTGVQAPLF	False
CSSRLENTLYF	False
CASSLWGANSDYTF	False
CASGDDWDYEQYF	False
CASSQATGGAVSQNTLYF	False
CASSISLWQNSGNTLYF	False
CASRATGRNTEVFF	True
CASSQDWGSYEQYF	False
CASSRTDQDTQYF	False
CASSQDGGNTLYF	False
CASKTGGSQNTLYF	False
CASSDPSSQNTLYF	False
CASSLWDRVEQYF	False
CASSIRGRNTEVFF	False
CASSEGDTQYF	False
CASSQRPGQSNERLFF	False
CASSSRGAETLYF	False
CASSDEGGSAETLYF	False
CASSLIDRGQYF	False
CASSADTLYF	False
CASSLVGGEQYF	False
CAWSPWSQNTLYF	False
CASSSGNYNSPLYF	False
CASSLVQGAYEQYF	False
CASSSDRANTEVFF	False
CASSLGTGGVSAETLYF	False
CASSIYWGGVEQYF	False
CASSRDRSGGGQDTQYF	False
CASSAGLGDEQYF	False
CASSRVQNTLYF	False
CASSLAGWSDYTF	False
CASSWDWGSQNTLYF	False
CASSDLNERLFF	False
CASSWTGANYAEQFF	False
CASRPGGYNSPLYF	False
CGARDQTNANTEVFF	False
CASSLRTVNTEVFF	False
CASSPQTENTGQLYF	False
CTCSAGRQANSDYTF	False
CASSIEDWGVQNTLYF	False
CASSLDWGSSYEQYF	True
CASSLDWTGIAEQFF	False
CASSDGANSDYTF	False
CASSQGGTSNTEVFF	False
CASGDARDRGNNNQAPLF	True
CASSFSWLYAEQFF	False
CTCSADHTGGFSYEQYF	True
CASGEGNANTEVFF	False
CGARSRDRGGQLYF	False
CASSFSGSYEQYF	False
CGARDRGGPSNERLFF	False
CASSRDRGRGNTLYF	False
CASTGQQDTQYF	True
CASSQGDISGNTLYF	False
CASSDRGGTYEQYF	False
CTCSAGGDTGQLYF	False
CASSYRDRGSDYTF	False
CASSHGTGEQYF	False
CASSLGGSSYEQYF	False
CASGDRGQVFF	False
CASRCPDRGNSDYTF	False
CASSETRNERLFF	True
CASSIHQDTQYF	False
CASSGQGAYTGQLYF	False
CASSLGVNQDTQYF	False
CASSLSGGSSAETLYF	False
CASSYGGGDQDTQYF	False
CASGEGTGAGNTLYF	False
CASSQRGEDTQYF	False
CASTGTGRSDYTF	False
CASSQDYYEQYF	False
CASSQDDWGEDTQYF	False
CASSDGGEEVFF	False
CASGDGRNTEVFF	False
CASGDADSSGNTLYF	False
CASSIAPNSNERLFF	False
CASRGNNNQAPLF	False
CASGDVGGPETLYF	False
CASSQDPVIETLYF	False
CASSVRDPRERLFF	False
CASSIGKDTQYF	False
CASSQDRDYEQYF	False
CASSDWGGAETLYF	False
CASSWDNSYEQYF	False
CASSRGANTGQLYF	False
CASSEGRADYTF	False
CASSDRNTLYF	False
CASRDRADTQYF	False
CAWSLRDWENTGQLYF	False
CASGATGGENTLYF	False
CASSSGTALGQNTLYF	False
CASSPNRGEDTQYF	False
CASSPGPSNTEVFF	False
CASSQDLGGGNQDTQYF	False
CASGDALGAETLYF	False
CASSWTTNSDYTF	False
CASSANTEVFF	False
CASSGWENQDTQYF	False
CASSPGLGVYAEQFF	False
CASSLGQNYAEQFF	False
CASSANYEQYF	False
CASSPGLGGRYEQYF	False
CASSLEGSGQLYF	False
CASSQGADSDYTF	False
CASSPPTGGKEQYF	False
CTCSADRAEVFF	False
CASSLWDTEVFF	False
CASSLDWGKDTQYF	False
CASSPSWGGAGTQYF	False
CASSDRDQAPLF	True
CASSEYREEVFF	False
CASSLRDRVYAEQFF	False
CASEDNSGNTLYF	False
CASSGGQGISNERLFF	False
CASSQDWIAETLYF	False
CASSQGYEQYF	False
CASSQPGLGGRAEQFF	False
CASSPSGHEQYF	False
CASSLANSYEQYF	False
CASGDALGGETLYF	False
CASSQDLGSEVFF	False
CASSPTGGQDTQYF	False
CASSLDNTQLYF	True
CASSLFRTGGSQNTLYF	False
CASSQDSGGAAETLYF	False
CASSLGQGGNNQAPLF	False
CASSIGFEQYF	False
CASSSGGNQDTQYF	False
CASSLFGSYEQYF	True
CASSQDINQDTQYF	False
CASGDLGGQEQYF	False
CASSIPTGGPNTGQLYF	False
CASSQRTGGAQDTQYF	False
CASSNRDEQYF	False
CASSLRDSHTEVFF	False
CTCSPGTGGYERLFF	False
CASSQDGWGGDQDTQYF	False
CASSGTYQDTQYF	False
CASSSYRTSQNTLYF	True
CASGDRQGNSPLYF	False
CASSPDWGNQDTQYF	False
CASGDPGGDYAEQFF	False
CASSLGWGAPYAEQFF	False
CASSNSYEQYF	False
CASSSGTGGQNTLYF	False
CASSPGQNNSPLYF	False
CASSRDREGAEQFF	False
CASGDLEAPLF	False
CASGDRTGGSAETLYF	False
CASSDVWTSAETLYF	False
CASSFQNNYAEQFF	False
CASSDWGGDSQNTLYF	False
CGAPTGLQDTQYF	False
CASGDSYNNQAPLF	False
CASSPPDWDQDTQYF	False
CASGPGQGAYNSPLYF	False
CASSFQGRGNTEVFF	False
CASSSLRQNTLYF	False
CASSPSGTGGYEQYF	False
CASRHRGRNTEVFF	True
CASSLTGGAYAEQFF	False
CASGRDWGGPNTGQLYF	True
CASSTGGGQDTQYF	False
CAWSSRDRGHTQYF	False
CASSDATEVFF	False
CASSDSYNYAEQFF	True
CASSFRDRVQNTLYF	False
CASSFGNSQNTLYF	False
CASGDEAVYNSPLYF	False
CASRDSGNTLYF	False
CASSEEGADSDYTF	False
CASSDGWESNERLFF	False
CASSIGWGEGTQYF	False
CASKNWGGEDTQYF	False
CASSYTGDTGQLYF	False
CASSDQNERLFF	False
CASSMRLGGLEQYF	False
CASSPRQGGQDTQYF	False
CASSIPGQTNTEVFF	False
CASSLLGYYAEQFF	True
CASSPDRNTGQLYF	False
CASSPDSQDTQYF	False
CASGQGEVFF	False
CASRGLGEGYAEQFF	True
CASSLEGGDTEVFF	False
CASSNGTGGSSYEQYF	False
CASSLDWGGSQNTLYF	False
CASSLGTGPNERLFF	False
CASSSLGGEQYF	True
CASSGTGGAGEQYF	False
CASSQDRGGWDTQYF	False
CASRWDWGAEQFF	False
CASSETGKDTQYF	False
CASSQGGLGGLEQYF	False
CASGQINSDYTF	True
CASSPSGTNSGNTLYF	True
CASSSLRDSNYAEQFF	False
CASSDSRAEVFF	False
CASSYPTGGANTEVFF	False
CASSGTGDGYAEQFF	False
CASSIPTGGVAETLYF	False
CTCSEGRNTEVFF	False
CAWGHLQDTQYF	False
CASSLEGTGSAEQFF	False
CTCSADPWGPSQNTLYF	True
CGARGTEQAPLF	False
CASSDYSNTEVFF	True
CASPGESTGQLYF	False
CASSDVHTEVFF	False
CASSQDLGGEVFF	False
CASSQDGGPNQDTQYF	False
CGARDQDRGNSDYTF	False
CASSFAGGAGNTLYF	True
CASSSDRGLEQYF	False
CASGDALSNERLFF	False
CASGGGVQDTQYF	False
CASSFSINQDTQYF	True
CASSLTGFSGNTLYF	False
CASGDLLDSYEQYF	False
CASSEGDSYEQYF	False
CASSQGTVGNTLYF	False
CASSLGGAGTEVFF	False
CASGDAASAETLYF	False
CASSSTGGAREQYF	False
CASSSRGWDSDYTF	False
CASSHSNERLFF	False
CASSIGKHSDYTF	False
CASSLSGAGNTLYF	False
CTCSAWGTEVFF	False
CASSLGDWGVEQYF	False
CASSQSGANTEVFF	False
CASGDEEGGNTLYF	False
CASSDADRGNERLFF	False
CASSLGDWGGYAEQFF	False
CASSLGGEQYF	False
CASSEDWGVSYEQYF	False
CASSSPVEQYF	False
CTCSGTGGSQNTLYF	False
CASSRDWGGEEQYF	False
CASSFDNTGQLYF	False
CASSGQGNNQAPLF	False
CASSLAGGNQAPLF	False
CASSDAGGAAEQFF	True
CASSHSDRGDQDTQYF	False
CASGTGGNSPLYF	False
CASGPGGSYEQYF	False
CASGDVQQNTLYF	False
CASSIIGYEQYF	False
CASSIGRGNYAEQFF	False
CASGGRDWGANSYEQYF	False
CASSLRDWGVGEQYF	False
CTCSADLGDSYEQYF	False
CASSQDLGVQAPLF	False
CASSLDWGGLYF	False
CTCSADRVGNQAPLF	False
CASSPDWGGSAETLYF	False
CASSPTRANYAEQFF	False
CASSGGGNYAEQFF	False
CASSPDSSGNTLYF	False
CASSPRGEQYF	False
CASSHRGASAETLYF	False
CGARDLGQGNSDYTF	False
CAWSQTGRNSDYTF	False
CASGEGTGVLSYEQYF	False
CASSLGGGANERLFF	False
CASSSSGDWGDNYAEQFF	False
CASSLENGGFYEQYF	False
CASSPRTGANYAEQFF	True
CASSQQETLYF	False
CASSRLGASAETLYF	False
CASSGLGDYAEQFF	False
CASSPDRGQNTLYF	True
CASIHRGQYTEVFF	False
CASSENEQYF	False
CASSGTGEVFF	False
CASSEDKYAEQFF	False
CASSATGFSNERLFF	False
CASSQNRAISNERLFF	False
CASSIFQAANSDYTF	False
CASSLATGFSGNTLYF	False
CTCSADRGGDTQYF	False
CASSQVGGQYAEQFF	False
CASRTGNERLFF	False
CASGDGGNSDYTF	True
CASSDGTTSYNSPLYF	False
CASTHYRGSAETLYF	True
CASSRGTGGDQDTQYF	False
CASSDVGGPNERLFF	False
CGARAPRQGETLYF	False
CASRDRGDTQYF	False
CASSSGGLNYAEQFF	False
CASRGTGMKNTLYF	False
CASSLEPPYEQYF	True
CASSRDWGVREQYF	False
CASSEGYEQYF	False
CASRHRGRQNTLYF	False
CAGGLGANTGQLYF	False
CASRDRGDSDYTF	True
CAWTGGGTLYF	False
CASSYRDRVSYEQYF	False
CASSLQGDEQYF	False
CASSDAGDSNERLFF	False
CTCSGRETEVFF	False
CASRGRNSDYTF	False
CTCSADPANTEVFF	False
CASSQEWGGGTGQLYF	False
CTCSGLGANYAEQFF	False
CASSDPGHNNQAPLF	False
CASGDRLGEYF	False
CGARDPGASAETLYF	False
CASSWDWGYEQYF	False
CASGDEGGNTGQLYF	False
CASSPGVNTLYF	False
CASSLHQGNTGQLYF	False
CTCSAGQGAEQFF	False
CASGEDWGDTGQLYF	False
CASGDAGLGYAEQFF	False
CASSLPRQAPLF	False
CASSLRDGRAEQFF	False
CASSWDWGNQDTQYF	False
CASSPGQGAKAPLF	False
CASSLAGGSDYTF	False
CASSRDWGGSAETLYF	False
CASSLWGGVSYEQYF	True
CASGDAQGAETLYF	False
CASSGTGDEQYF	False
CASSLYTF	False
CASSQEAETLYF	False
CSSSQRQNPYEQYF	False
CASSFLGYAEQFF	True
CASSLGLGADTQYF	True
CASSLGTGAYEQYF	False
CASGDWGGSQNTLYF	False
CASSQDVNQDTQYF	False
CASSDGLGGFEQYF	False
CTCSAGTLQDTQYF	False
CTCSEGSNERLFF	False
CASSSGGANSDYTF	False
CASSLSGLGGNYAEQFF	False
CASGDAGARAEVFF	True
CASGDAGGGNERLFF	False
CASSLAGANERLFF	True
CAWKLTGGQNTLYF	False
CASGERQGDTGQLYF	False
CASSLTGASQNTLYF	False
CASSEGFSNERLFF	False
CASSETGSGNTLYF	False
CASSPRGSSGNTLYF	False
CASSPDRGREQYF	True
CASSLDWGGNYAEQFF	False
CASSPRDRQDTQYF	False
CASSDARHYEQYF	False
CASGGWGGTQYF	False
CASRYSGGWWEQFF	False
CASSRTGGRSYEQYF	False
CASGDAQGNERLFF	False
CASSRQHQDTQYF	False
CASSRDWGGEDTQYF	False
CTCSAEAFSNERLFF	False
CASSDTSSYNSPLYF	False
CASSFGGNTEVFF	False
CASSDTGVGQLYF	True
CASSWGGEQYF	False
CASSRLGGGQNTLYF	False
CASSDVWEDTQYF	False
CASSPSTEVFF	False
CASSFFDRANTEVFF	False
CASPRDRGCAETLYF	False
CASSGQNTLYF	False
CASSITGFSDYTF	False
CASRGTGGSAETLYF	False
CASSQDPVYNSPLYF	False
CSSSGDWGGSSYEQYF	False
CASSIRDNKNTEVFF	False
CASSQEGGASAETLYF	False
CASSATSNSDYTF	False
CASGDAGQSSGNTLYF	False
CASSLNNSPLYF	False
CASSLGGYYAEQFF	False
CASRDNSYNSPLYF	True
CASSLDDWGSSYEQYF	True
CASSIAQGNTEVFF	False
CASSHRDKNTEVFF	False
CTCSAWDEQYF	False
CAGGNTGQLYF	False
CASSLGGVQNTLYF	False
CASSSIRGPNERLFF	False
CASSSGRNTEVFF	False
CASGEGLGGNYAEQFF	False
CASSWSWGNYEQYF	False
CASSLQGEVFF	True
CASSTGGPNERLFF	False
CASGGTGREQYF	False
CASSLWDNSDYTF	False
CASSLDWGSAETLYF	False
CASSSGGANYAEQFF	False
CASSQVQGNTLYF	False
CGAREGGLYEQYF	False
CAIPGQGDTQYF	True
CASSFGTAYAEQFF	False
CASRLTQNTLYF	False
CASSLDRVYAEQFF	False
CGARGTRISGNTLYF	False
CASRVGGDTGQLYF	False
CASSRAPLGINQDTQYF	True
CASSLDSSQNTLYF	False
CASSDALNTLYF	False
CASSEGGYQNTLYF	False
CASSWTGANTEVFF	False
CASSLAGSSYEQYF	False
CASSFPKGLGGSQNTLYF	False
CASSAGGQNTLYF	False
CASSPGTKNTLYF	False
CASRLSSYEQYF	False
CASSGGLGGFAEQFF	False
CASSPGTGGVYEQYF	False
CTCSGTGNTEVFF	False
CASAERENTLYF	False
CASSFSYEQYF	False
CASGYREGAETLYF	False
CASSDWQGISNERLFF	False
CTCSAGTSANTEVFF	False
CASSPQGVFAETLYF	True
CASSGRDSPSYEQYF	False
CASSGDRSAETLYF	False
CASSMGQGQNTLYF	False
CASSGGERLFF	False
CASSDSGGQDTQYF	False
CASSLPTGGQDTQYF	False
CASSPDRLTGQLYF	False
CASSLGDQDTQYF	False
CTCSARTGRNSPLYF	False
CASGDATGGRDYAEQFF	False
CTCSAGRDRGNYAEQFF	False
CASSDLDSGNTLYF	False
CASSDARTGVYAEQFF	False
CASSQREAPLF	False
CASSLGRHANTEVFF	False
CASSQGAQKDTLYF	True
CSSSQGLGYEQYF	False
CASSQEWTGGDTQYF	False
CASSIDSYEQYF	False
CTCSAAGTGDAEQFF	False
CASSQDRAGGDEQYF	False
CASSLIRVTEVFF	False
CASGETGGDEQYF	False
CASSDRTGDYAEQFF	True
CASSLWGGSQNTLYF	False
CASSYSYEQYF	True
CASSGGQDEQYF	False
CASKTQGNYAEQFF	False
CASSDDNYAEQFF	False
CAWSLVNQDTQYF	False
CASSQGSNQDTQYF	False
CASSLGNYAEQFF	False
CASSFPDWGSYEQYF	False
CASSPRGTSAETLYF	False
CASSWDWGGASAEQFF	False
CASSKDNTEVFF	False
CASSQDWGGSSAETLYF	False
CASSPTGGDSDYTF	False
CASSQQDTQYF	False
CASKPRDRGSSAETLYF	False
CASSTGFSYNSPLYF	False
CASSRGEANTEVFF	False
CASSLGQGNTEVFF	False
CTCSAAGGGGQNTLYF	True
CASSLLGGPAEQFF	False
CASIQGTEQFF	False
CASSGDTQYF	False
CASSLTGAGAEQFF	True
CASSDAEGQNTLYF	False
CASSRQGSAETLYF	False
CGAKRDWGVAEQFF	True
CASSRDTQDTQYF	False
CGARDWGVSAETLYF	False
CASSLDDWGTYEQYF	True
CASSPVSNERLFF	False
CASSLRGTEVFF	False
CASSQEALRQGENTLYF	False
CASSQNWGRGDTQYF	False
CGARDIFSNERLFF	False
CASSLLGGREEQYF	False
CASGQGDEQYF	False
CASGDRDRGGEQYF	False
CASSPGQNTGQLYF	False
CASSNDWGYEQYF	False
CASSLDWGASAETLYF	False
CASSLVWTSAETLYF	False
CASRAGTDTEVFF	False
CASSPDRVYEQYF	False
CASRDWGGARAEQFF	False
CTCSAGGANSDYTF	False
CASSGTPSNERLFF	False
CASSTGQNTEVFF	False
CASSFGGNQDTQYF	True
CASSLGQYTEVFF	False
CASSDGGAFEQYF	False
CASSIHIYEQYF	False
CASSYGLGNTLYF	False
CASSLDWGRSQDTQYF	True
CASSLRGDNQAPLF	True
CASGAGGARDEQYF	False
CASSDWGDEQYF	False
CASSLLGSSYEQYF	False
CGARDGVNTLYF	False
CASRPDWGGNQDTQYF	False
CSSSQSRDQDTQYF	False
CASSFQGSYAEQFF	False
CASSRAGNYAEQFF	False
CASSQEGVDTQYF	False
CASSGGDNSGNTLYF	False
CASSLVGNTQYF	False
CASSDGTLSNERLFF	False
CASSPGQGQDTQYF	False
CASSQTGNTEVFF	False
CASSSDKGGSDYTF	False
CASGDATGGETLYF	False
CASSRGQGNGQLYF	False
CASSRTISNERLFF	False
CTCSADWGGSQNTLYF	False
CASSLTGVDTQYF	False
CASSDWGDNQDTQYF	True
CASSDRDRGLEQYF	False
CASWDRGEQYF	False
CTCSAEWDWGYEQYF	False
CGARDRTNSNSDYTF	False
CASSPTGSSSYEQYF	False
CASRTGGSQNTLYF	True
CASSLTSAETLYF	False
CASSDRNTEVFF	False
CTCSEGGSDYTF	False
CASSYRGEQYF	True
CASGDDRGGGAETLYF	False
CASSLGDGNTLYF	True
CASSQGLGAYEQYF	True
CASSPGGNYAEQFF	False
CASSLGGSGWEQYF	False
CASSLGVGTGQLYF	False
CASGDAGDWGGNYAEQFF	False
CASSVGQGNQAPLF	False
CASSRQGATTGQLYF	False
CASRPGTGVYEQYF	False
CASSDTSYEQYF	False
CASSIRLGQNTLYF	False
CASSLEQGGAETLYF	False
CASGEVWGEGAETLYF	False
CASSLNWGGDDAEQFF	False
CASSREGDTGQLYF	False
CASGERLQNTLYF	False
CGARDQTGGNTEVFF	False
CASSWDWGGAYAEQFF	False
CASSGDWGGYYAEQFF	False
CASSLGIYEQYF	False
CASSGTGGVQNTLYF	False
CASSLWTMNSDYTF	False
CASSPPGPSSYEQYF	False
CASSGTGGYEQYF	False
CASSETGAYEQYF	False
CASCDWGGGTQYF	False
CASRDRVITEVFF	False
CASGERLGGLNQDTQYF	False
CASSIWGVSQNTLYF	False
CASGGTGAGNTLYF	False
CASSNRGEDSDYTF	False
CASSHSGPYNSPLYF	False
CASSSGGTNERLFF	False
CASSLGQLNYAEQFF	False
CASSSGQGDTQYF	False
CASSPTGGSSQNTLYF	False
CTCSADRGVLYEQYF	False
CASSLLRRTGVGNTLYF	False
CASSLSTGGALHTQYF	False
CASSRGDYEQYF	False
CASSPGQVQDTQYF	False
CASSFDWGGGQDTQYF	False
CASSDVWGSQNTLYF	False
CASSQAGDGNTLYF	True
CASSRLGGFAETLYF	False
CASSLAPNSDYTF	False
CASGDAPGGAAQDTQYF	False
CASSRNGGSSDYTF	False
CASSLGGNYAEQFF	False
CASSLWQGAGNTLYF	True
CASGDWTGGALEQYF	False
CASRDRADTEVFF	False
CASGGTDYAEQFF	False
CASSETGGGQAPLF	False
CASSHDWGGAGQLYF	True
CASSLSQGADSDYTF	False
CASSPGGRLSAETLYF	False
CSSRMGMGEQYF	False
CASSFGTSYEQYF	False
CASSFGTGGHSPLYF	False
CASGEGPLYF	False
CASSYQGANSDYTF	False
CASSLNTGQLYF	False
CASSPGGTKNTLYF	False
CASSSHRGEQYF	True
CASSSDRNTGQLYF	False
CASSPDRGGNTLYF	False
CASSLGWGDQDTQYF	False
CASSDAKYEQYF	False
CASSDLRDISYEQYF	False
CASSRRDWGAPDEQYF	True
CASSDPGYTQYF	False
CASSDAPDWAFEEQYF	False
CASSDRVEQYF	False
CASSPRGANTGQLYF	False
CGARDPTQNTEVFF	False
CASSLGDWSYEQYF	False
CASGDWDWGGDEQYF	False
CASSPDWGKDTQYF	False
CASSILGYAEQFF	False
CASSYTGGSQNTLYF	False
CASSLDSRGKGQNTLYF	False
CASSLGLSSYEQYF	False
CASSPFRVNQDTQYF	False
CASGDAAGGVPGQLYF	False
CASSDRGRDAEQFF	False
CASTPGHNQAPLF	False
CASSLQNYAEQFF	False
CASSQDRAGNTLYF	True
CASSPGGEAEQFF	False
CASSSTRAYNSPLYF	False
CAWSLLGGGGSDYTF	False
CASSLGGFEQYF	False
CASSQTGGYYEQYF	False
CASSPHWGAEGNTLYF	False
CASSLTNSGNTLYF	True
CASSLGGLDTQYF	False
CASSQESGGPNERLFF	False
CASTPGGAQNTLYF	False
CASSPEGVNERLFF	True
CASSLSRGNYAEQFF	False
CASSSRTGGYEQYF	False
CASSQDQGGGNTLYF	False
CASSYAGAGNTLYF	False
CASSTGTGGAVEYAEQFF	False
CASSPLGAAEQFF	False
CASSLWDRGDTQYF	False
CASSPRGADAEQFF	False
CASREWGGYAEQFF	False
CASSPGTKKNTLYF	True
CASSGQGAGTGQLYF	False
CSSRGDTTEVFF	False
CASSPGHSNSDYTF	False
CASSQRQENTEVFF	False
CGARDQGTTNERLFF	False
CASSQDLNTEVFF	False
CASSPPRGSDTGQLYF	False
CASSRGGSQNTLYF	False
CASSPTGENTEVFF	False
CASSIEQGSYNSPLYF	False
CASSQDLGGRVFF	False
CASSLLGNTLYF	False
CASPGDRGRAEQFF	False
CASSQVKGDEQYF	False
CASSQDGTGNNERLFF	False
CASSETVSGNTLYF	False
CASSPSNNQAPLF	False
CASSDWEQDTQYF	False
CASSWGGAQNTLYF	False
CASSPLGDQDTQYF	False
CASRGTGANSDYTF	False
CASGDGTGGAYEQYF	False
CASSLDWGALYNYAEQFF	False
CASRWGNSGNTLYF	False
CASSRGTANSDYTF	False
CASRPSSQNTLYF	False
CASSSGTGGYAEQFF	False
CASGAPGQQDTQYF	False
CASSSRAGNTEVFF	True
CASSLGWGEYEQYF	False
CASSQGLGEQYF	False
CASSLRQYEQYF	False
CASSPWVGAETLYF	False
CASSGDRGFTEVFF	False
CASSIGTGNTEVFF	False
CASSLSQTNSDYTF	False
CASSFLQGYEQYF	False
CASSDQGASAETLYF	False
CGAGDISAETLYF	False
CASSSRANNSPLYF	True
CASSLLGEDTQYF	False
CASSFGPGGAEQFF	False
CASSQEGGRWAEQYF	True
CASSFHGTGGYEQYF	False
CASSRGRADNSPLYF	False
CASGDRGGGHEQYF	False
CASSITRSYEQYF	False
CASSEWGSSDYTF	False
CASRDRAVTLYF	False
CGAGTDAEQFF	False
CASSRGDNQDTQYF	False
CASSDGRAEQYF	False
CASGGLGGSSYEQYF	False
CASSDGEETLYF	False
CASSPTGGVYEQYF	True
CASSPAGGYEQYF	False
CASTPGLGGLYAEQFF	False
CAWRRTTISNERLFF	False
CASSQEGHANTEVFF	False
CAWSLDNTGQLYF	False
CTCSAEAGGCEQYF	False
CASSDAAKNTEVFF	False
CASSMPGGYQNTLYF	False
CASSRGDNQAPLF	True
CASSDSQNTLYF	False
CASSFNSYNSPLYF	False
CASRDSSYEQYF	False
CASSLGAGRGERLFF	False
CAAGVNSDYTF	False
CASSSGQNTEVFF	False
CASSSTGGQDTQYF	False
CASSETTNTEVFF	False
CASSLVGLGGDQNTLYF	True
CASGERLAPYEQYF	False
CASSPGQGAAEVFF	False
CASSLDNTEVFF	False
CASSFWTGGYAEQFF	True
CASSPGFANERLFF	False
CASSPGGGQDTQYF	False
CASGGGQGVEQYF	False
CASSPNWGGNTGQLYF	False
CASSLSLGGHAEQFF	False
CASSPNWGSETLYF	False
CASSFTGRNTEVFF	False
CASSHRAERLFF	False
CASSIGGRTERLFF	False
CASSLRGYERLFF	False
CASTGRGGRGEQYF	False
CASSMRGTEVFF	False
CASRQGADTQYF	False
CASSDSGAGTGQLYF	False
CASSLGGYAEQFF	False
CASSRLGGSQDTQYF	False
CASSSSQNTLYF	False
CASSRTGRGNTLYF	False
CASGDAGRETGNTLYF	False
CGARVGEAEVFF	False
CASSEGGGNSPLYF	False
CASGDRTGGNYAEQFF	False
